District code,State Name,District name,Population,Age_Group_0_29,Age_Group_30_49,Age_Group_50,Age not stated,Male,Female,Literate,Male_Literate,Female_Literate,Agricultural_Workers,Housholds_with_Electric_Lighting,Households_with_Internet,Households_with_Computer,Rural_Households,Urban_Households,Households,
1,JAMMU AND KASHMIR,Kupwara,870354,600759,178435,89679,1481,474190,396164,439654,282823,156831,56759,83071,762,5256,158438,23226,181664,
2,JAMMU AND KASHMIR,Badgam,753745,503223,160933,88978,611,398041,355704,335649,207741,127908,36630,90190,1999,5892,160649,27190,187839,
3,JAMMU AND KASHMIR,Leh(Ladakh),133487,70703,41515,21019,250,78971,54516,93770,62834,30936,1645,17250,574,2150,36920,17474,54394,
4,JAMMU AND KASHMIR,Kargil,140802,87532,35561,17488,221,77785,63017,86236,56301,29935,3763,15824,235,1005,40370,7774,48144,
5,JAMMU AND KASHMIR,Punch,476835,304979,109818,61334,704,251899,224936,261724,163333,98391,31583,62900,346,3342,132139,15269,147408,
6,JAMMU AND KASHMIR,Rajouri,642415,404903,153165,83319,1028,345351,297064,364109,224469,139640,24016,96012,673,6219,196070,17508,213578,
7,JAMMU AND KASHMIR,Kathua,616435,357864,160123,97684,764,326109,290326,389204,228499,160705,21566,109422,1443,6112,181374,33473,214847,
8,JAMMU AND KASHMIR,Baramula,1008039,636524,239659,130513,1343,534733,473306,545149,337170,207979,62246,138180,3698,10645,210543,48932,259475,
9,JAMMU AND KASHMIR,Bandipore,392232,252378,90465,48802,587,207680,184552,185979,117058,68921,32882,45469,985,3155,80521,17555,98076,
10,JAMMU AND KASHMIR,Srinagar,1236829,693238,351561,190330,1700,651124,585705,748584,431746,316838,10408,165403,16413,33831,4518,257721,262239,
11,JAMMU AND KASHMIR,Ganderbal,297446,194165,66945,35911,425,158720,138726,143276,90581,52695,19312,38487,878,2779,63788,13558,77346,
12,JAMMU AND KASHMIR,Pulwama,560440,342601,137032,80111,696,293064,267376,293958,178326,115632,34080,73629,1537,5293,147520,21703,169223,
13,JAMMU AND KASHMIR,Shupiyan,266215,170086,60752,35158,219,136480,129735,136500,80355,56145,10835,35282,884,3440,75616,5272,80888,
14,JAMMU AND KASHMIR,Anantnag,1078692,704145,239988,133519,1040,559767,518925,545532,324417,221115,76364,114899,2712,8612,207067,70666,277733,
15,JAMMU AND KASHMIR,Kulgam,424483,266858,99870,57253,502,217620,206863,209085,125052,84033,29928,47913,838,3542,95952,25178,121130,
16,JAMMU AND KASHMIR,Doda,409936,263576,93189,52744,427,213641,196295,219083,138620,80463,12199,61831,596,3077,122267,11350,133617,
17,JAMMU AND KASHMIR,Ramban,283713,188526,61604,33220,363,149132,134581,124065,82938,41127,8810,34243,417,2644,84281,5341,89622,
18,JAMMU AND KASHMIR,Kishtwar,230696,145931,53415,31084,266,120165,110531,107506,68700,38806,16296,24067,274,1651,72378,5993,78371,
19,JAMMU AND KASHMIR,Udhampur,554985,339145,140785,74757,298,296784,258201,322354,197543,124811,11396,73999,1214,5744,148664,34696,183360,
20,JAMMU AND KASHMIR,Reasi,314667,203967,70767,39743,190,166461,148206,150542,93937,56605,4009,31588,602,2849,95572,12261,107833,
21,JAMMU AND KASHMIR,Jammu,1529958,816827,435895,275585,1651,813821,716137,1137135,641916,495219,36873,294739,19905,46657,254566,248043,502609,
22,JAMMU AND KASHMIR,Samba,318898,177277,88246,53022,353,169124,149774,228139,130312,97827,6105,61159,992,4465,94247,19989,114236,
23,HIMACHAL PRADESH,Chamba,519080,306555,130606,81566,353,261320,257760,323842,186064,137778,9193,96082,1615,5117,186395,13836,200231,
24,HIMACHAL PRADESH,Kangra,1510075,766581,419172,319420,4902,750591,759484,1152640,606443,546197,54849,330081,8053,22753,588321,39007,627328,
25,HIMACHAL PRADESH,Lahul AND Spiti,31564,15928,9181,6200,255,16588,14976,21845,12897,8948,572,5618,61,252,17434,0,17434,
26,HIMACHAL PRADESH,Kullu,437903,244727,120510,72282,384,225452,212451,307672,174550,133122,12372,91322,2623,7010,167995,20709,188704,
27,HIMACHAL PRADESH,Mandi,999777,524285,279321,194661,1510,498065,501712,723747,393669,330078,15822,214491,5333,16401,431129,31696,462825,
28,HIMACHAL PRADESH,Hamirpur,454768,224044,123941,106641,142,217070,237698,358091,180555,177536,8824,104120,2521,7525,196116,15232,211348,
29,HIMACHAL PRADESH,Una,521173,273223,142351,105358,241,263692,257481,399715,213281,186434,19604,105929,2412,8238,185091,20126,205217,
30,HIMACHAL PRADESH,Bilaspur,381956,193671,107367,80497,421,192764,189192,287620,155599,132021,4138,79146,1574,6281,152458,11987,164445,
31,HIMACHAL PRADESH,Solan,580320,321533,167168,90808,811,308754,271566,428578,244372,184206,10283,119866,5250,14478,192787,51509,244296,
32,HIMACHAL PRADESH,Sirmaur,529855,310244,136839,82471,301,276289,253566,362645,205617,157028,10730,91509,2220,8593,171102,21054,192156,
33,HIMACHAL PRADESH,Shimla,814010,425721,241956,145577,756,425039,388971,612642,342846,269796,26114,172754,9177,24127,279269,95896,375165,
34,HIMACHAL PRADESH,Kinnaur,84121,42360,26599,15075,87,46249,37872,60699,36697,24002,2537,17865,354,2563,44514,0,44514,
35,PUNJAB,Gurdaspur,2298323,1261421,611353,423301,2248,1212617,1085706,1634719,907660,727059,100684,411216,14428,38445,420860,185488,606348,
36,PUNJAB,Kapurthala,815168,433331,222324,157833,1680,426311,388857,576567,316254,260313,42387,161206,9732,23145,165433,95770,261203,
37,PUNJAB,Jalandhar,2193590,1159156,616431,416449,1554,1145211,1048379,1622537,882581,739956,66664,446200,39082,79134,330339,377791,708130,
38,PUNJAB,Hoshiarpur,1586625,831741,422782,330671,1431,809057,777568,1199699,637927,561772,74362,319930,13747,34328,422673,128592,551265,
39,PUNJAB,Shahid Bhagat Singh Nagar,612310,318597,163305,128310,2098,313291,299019,438459,239155,199304,22626,125068,5264,13936,183168,48383,231551,
40,PUNJAB,Fatehgarh Sahib,600163,321018,166781,111028,1336,320795,279368,426033,238696,187337,21389,113683,5138,14294,117559,57337,174896,
41,PUNJAB,Ludhiana,3498739,1901528,980046,614258,2907,1867816,1630923,2560225,1428348,1131877,98646,703624,58589,123400,395032,641789,1036821,
42,PUNJAB,Moga,995746,535408,258826,194768,6744,525920,469826,627889,348549,279340,82397,183396,7897,21662,214295,74144,288439,
43,PUNJAB,Firozpur,2029074,1171770,525459,331259,586,1071637,957437,1227511,707070,520441,227971,349662,10042,31070,348522,153868,502390,
44,PUNJAB,Muktsar,901896,495167,242628,162297,1804,475622,426274,524848,300401,224447,111014,166585,4571,14077,149507,74650,224157,
45,PUNJAB,Faridkot,617508,336540,164962,113721,2285,326671,290837,381285,215767,165518,54058,113549,4348,12276,99946,58917,158863,
46,PUNJAB,Bathinda,1388525,754927,377707,255283,608,743197,645328,844868,488261,356607,128382,255650,11284,32253,218159,137563,355722,
47,PUNJAB,Mansa,769751,420050,200882,146103,2716,408732,361019,423560,244037,179523,90367,140099,2673,10085,145603,50786,196389,
48,PUNJAB,Patiala,1895686,1042519,517079,335100,988,1002522,893164,1266791,711052,555739,89123,352929,24274,55105,299279,218090,517369,
49,PUNJAB,Amritsar,2490656,1384987,667193,436496,1980,1318408,1172248,1684770,932981,751789,121599,461231,29961,63864,275477,385476,660953,
50,PUNJAB,Tarn Taran,1119627,641875,283645,190898,3209,589369,530258,666162,376427,289735,81216,186599,4300,13102,222717,44457,267174,
51,PUNJAB,Rupnagar,684627,365300,185424,131707,2196,357485,327142,502731,278534,224197,21520,129123,6600,17542,148162,60537,208699,
52,PUNJAB,Sahibzada Ajit Singh Nagar,994628,540872,281462,171656,638,529253,465375,736575,409944,326631,21791,191578,25944,50857,117293,174042,291335,
53,PUNJAB,Sangrur,1655169,904316,435148,311621,4084,878029,777140,1002077,570413,431664,91799,305557,10736,30955,292156,156788,448944,
54,PUNJAB,Barnala,595527,322607,158413,114077,430,317522,278005,359831,201999,157832,40460,108908,3501,10566,102577,54222,156799,
55,CHANDIGARH,Chandigarh,1055450,602411,303748,148945,346,580663,474787,805438,465346,340092,1687,231204,44283,78113,8911,289456,298367,
56,UTTARAKHAND,Uttarkashi,330086,202426,75997,51245,418,168597,161489,215126,128237,86889,4387,52621,602,4104,112148,9061,121209,
57,UTTARAKHAND,Chamoli,391605,229715,93182,67873,835,193991,197614,280556,155395,125161,3845,71524,899,5582,163434,22906,186340,
58,UTTARAKHAND,Rudraprayag,242285,141848,54979,44986,472,114589,127696,170933,91803,79130,3200,49182,418,3082,112705,4454,117159,
59,UTTARAKHAND,Tehri Garhwal,618931,368324,139371,109998,1238,297986,320945,407994,227406,180588,8129,117239,1366,7831,227059,27177,254236,
60,UTTARAKHAND,Dehradun,1696694,968517,446046,276280,5851,892199,804495,1259506,702216,557290,38195,310726,25862,71199,228245,269393,497638,
61,UTTARAKHAND,Garhwal,687271,380765,160183,145445,878,326829,360442,494889,262148,232741,13715,143963,2633,12670,279682,36780,316462,
62,UTTARAKHAND,Pithoragarh,483439,273494,116749,92517,679,239306,244133,345550,189623,155927,5432,95421,1344,7932,183687,26256,209943,
63,UTTARAKHAND,Bageshwar,259898,147488,60569,51672,169,124326,135572,179483,97546,81937,8985,47083,435,3595,96031,3880,99911,
64,UTTARAKHAND,Almora,622506,351595,141238,128994,679,291081,331425,436497,231604,204893,10274,109876,1830,9858,260056,21082,281138,
65,UTTARAKHAND,Champawat,259648,156916,60722,41913,97,131125,128523,177726,102015,75711,4032,37725,548,3159,85202,12839,98041,
66,UTTARAKHAND,Nainital,954605,562548,243095,147053,1909,493666,460939,696500,385779,310721,34742,169001,7265,26270,193086,105577,298663,
67,UTTARAKHAND,Udham Singh Nagar,1648902,1042614,392370,212223,1695,858783,790119,1037839,598525,439314,165250,254802,7883,28053,269406,145253,414659,
68,UTTARAKHAND,Hardwar,1890422,1207120,435385,246229,1688,1005295,885127,1178354,691411,486943,103115,279012,11947,35023,301828,186183,488011,
69,HARYANA,Panchkula,561293,309078,157076,93606,1533,299679,261614,405318,229862,175456,12827,103455,18615,32174,70895,93656,164551,
70,HARYANA,Ambala,1128350,617859,308126,201685,680,598703,529647,818025,461288,356737,57293,199681,12899,32767,175365,139891,315256,
71,HARYANA,Yamunanagar,1214205,694813,317708,201386,298,646718,567487,832457,474793,357664,73251,217503,8079,25129,214464,143259,357723,
72,HARYANA,Kurukshetra,964655,552034,250830,160216,1575,510976,453679,646893,370828,276065,85890,171908,7356,21951,203553,88268,291821,
73,HARYANA,Kaithal,1074304,630194,265813,176320,1977,571003,503301,646529,385782,260747,85651,187349,3724,15301,231091,75696,306787,
74,HARYANA,Karnal,1505324,884972,380409,234684,5259,797712,707612,978013,564516,413497,133723,267223,11163,29253,292682,135920,428602,
75,HARYANA,Panipat,1205437,739075,298764,167244,354,646857,558580,786599,464136,322463,62358,209965,10024,26719,173502,153804,327306,
76,HARYANA,Sonipat,1450001,855201,360216,233318,1266,781299,668702,998316,589881,408435,101733,253054,9029,30697,283858,133576,417434,
77,HARYANA,Jind,1334152,784085,335704,213478,885,713006,621146,832758,502049,330709,102071,222462,5263,23750,278335,89665,368000,
78,HARYANA,Fatehabad,942011,555745,237009,147469,1788,495360,446651,557578,327471,230107,97997,153301,3210,13142,203020,55360,258380,
79,HARYANA,Sirsa,1295189,750228,334344,208185,2432,682582,612607,782897,456968,325929,147042,215527,6287,22706,245476,93316,338792,
80,HARYANA,Hisar,1743931,1017830,456536,265109,4456,931562,812369,1114311,670200,444111,144213,285004,10132,33400,302013,154113,456126,
81,HARYANA,Bhiwani,1634445,964960,405760,261428,2297,866672,767773,1069871,643158,426713,103788,266244,5292,25236,357047,99235,456282,
82,HARYANA,Rohtak,1061204,605741,269354,185685,424,568479,492725,747582,436025,311557,36568,193120,8482,27225,175203,131739,306942,
83,HARYANA,Jhajjar,958405,549975,245095,162356,979,514667,443738,676091,399480,276611,44845,168558,5034,19241,211816,78328,290144,
84,HARYANA,Mahendragarh,922088,530000,229392,161258,1438,486665,435423,630255,380440,249815,38320,135455,2624,13908,223726,44216,267942,
85,HARYANA,Rewari,900332,518747,230704,150557,324,474335,425997,636947,375453,261494,28215,152651,5121,18092,199449,69305,268754,
86,HARYANA,Gurgaon,1514432,875531,428101,210307,493,816690,697742,1111116,638666,472450,27097,305751,67087,102343,141703,381988,523691,
87,HARYANA,Mewat,1089263,790930,186916,110688,729,571162,518101,454897,308435,146462,55278,96309,935,10499,187398,36237,223635,
88,HARYANA,Faridabad,1809733,1095602,481318,231029,1784,966110,843623,1272739,734940,537799,29288,333171,43437,82673,87700,382981,470681,
89,HARYANA,Palwal,1042708,684189,224043,133913,563,554497,488211,599796,379696,220100,60685,132606,4283,16736,186069,63090,249159,
90,NCT OF DELHI,North West,3656539,2138591,1013424,503055,1469,1960922,1695617,2707855,1541952,1165903,13289,720900,114044,188876,67592,959275,1026867,
91,NCT OF DELHI,North,887978,506601,256501,124513,363,475002,412976,681517,381615,299902,1791,174310,21418,40543,4512,296559,301071,
92,NCT OF DELHI,North East,2241624,1393078,581016,264663,2867,1188425,1053199,1611588,912481,699107,2406,391951,30390,69417,5326,482255,487581,
93,NCT OF DELHI,East,1709346,948963,497157,262124,1102,907500,801846,1352998,748382,604616,3094,352758,80037,127465,1086,461132,462218,
94,NCT OF DELHI,New Delhi,142004,76076,43913,21773,242,77942,64062,114179,65678,48501,275,30023,7366,11948,0,52664,52664,
95,NCT OF DELHI,Central,582320,317650,169533,94448,689,307821,274499,442360,240518,201842,601,113399,19724,30627,0,194897,194897,
96,NCT OF DELHI,West,2543243,1399165,732515,408953,2610,1356240,1187003,1961179,1093933,867246,4358,520282,109666,171002,1809,699703,701512,
97,NCT OF DELHI,South West,2292958,1296955,683209,308675,4119,1246046,1046912,1787689,1025261,762428,7753,457784,94853,156635,41179,606503,647682,
98,NCT OF DELHI,South,2731929,1588001,785085,355602,3241,1467428,1264501,2078402,1185036,893366,5908,549402,111453,176435,2918,728145,731063,
99,RAJASTHAN,Ganganagar,1969168,1167889,502211,283484,15584,1043340,925828,1193343,710908,482435,230438,283142,6295,24901,397697,164897,562594,
100,RAJASTHAN,Hanumangarh,1774692,1058044,453114,242361,21173,931184,843508,1034136,624281,409855,166833,243163,3360,16217,389059,108694,497753,
101,RAJASTHAN,Bikaner,2363937,1543867,517271,288165,14634,1240801,1123136,1278801,782399,496402,103833,220793,7607,29531,335754,196179,531933,
102,RAJASTHAN,Churu,2039547,1293193,458725,272176,15453,1051446,988101,1149269,696729,452540,87983,231696,2577,15259,344897,148996,493893,
103,RAJASTHAN,Jhunjhunun,2137045,1298780,494124,330126,14015,1095896,1041149,1370360,815834,554526,68878,297559,4828,24178,500452,150357,650809,
104,RAJASTHAN,Alwar,3674179,2346721,836000,490137,1321,1939026,1735153,2182476,1359829,822647,216772,485723,9750,45770,782294,212967,995261,
105,RAJASTHAN,Bharatpur,2548462,1659515,546362,329127,13458,1355726,1192736,1480869,943910,536959,238894,288723,4179,26106,479437,129697,609134,
106,RAJASTHAN,Dhaulpur,1206516,815651,248416,141365,1084,653647,552869,683098,435721,247377,74342,96086,1330,9504,214670,58626,273296,
107,RAJASTHAN,Karauli,1458248,947173,310688,192042,8345,783639,674609,805849,531904,273945,115367,132079,1059,13045,305047,59308,364355,
108,RAJASTHAN,Sawai Madhopur,1335551,841697,309237,183234,1383,704031,631520,741748,486184,255564,88804,140947,1887,14310,282057,71264,353321,
109,RAJASTHAN,Dausa,1634409,1047136,358718,210117,18438,857787,776622,938051,596935,341116,76277,195277,1719,14539,361084,59610,420694,
110,RAJASTHAN,Jaipur,6626178,4091148,1646480,884057,4493,3468507,3157671,4300965,2554793,1746172,131523,990085,76565,182350,754841,977838,1732679,
111,RAJASTHAN,Sikar,2677333,1672813,605002,381226,18292,1374990,1302343,1652117,995275,656842,87889,339457,5647,28382,527560,178274,705834,
112,RAJASTHAN,Nagaur,3307743,2088323,754143,463469,1808,1696325,1611418,1758624,1102750,655874,263401,347344,4449,35328,675712,166489,842201,
113,RAJASTHAN,Jodhpur,3687165,2359786,836322,489280,1777,1923928,1763237,2031532,1265753,765779,242017,408808,19335,54808,584215,307442,891657,
114,RAJASTHAN,Jaisalmer,669919,448969,140294,79977,679,361708,308211,308653,210415,98238,43872,43141,754,7416,159117,30830,189947,
115,RAJASTHAN,Barmer,2603751,1731122,527629,326476,18524,1369022,1234729,1188322,783461,404861,132696,126494,2766,37730,542825,55980,598805,
116,RAJASTHAN,Jalor,1828730,1176496,390598,249379,12257,936634,892096,829582,543923,285659,158013,161845,1585,12794,419216,48202,467418,
117,RAJASTHAN,Sirohi,1036346,649290,244401,142251,404,534231,502115,476806,309900,166906,97823,134089,2146,10297,238535,69639,308174,
118,RAJASTHAN,Pali,2037573,1207983,467436,343384,18770,1025422,1012151,1085693,667381,418312,237280,326793,4043,19270,512909,139808,652717,
119,RAJASTHAN,Ajmer,2583052,1561077,629951,388040,3984,1324085,1258967,1526673,926268,600405,145523,393498,13499,41732,409335,274919,684254,
120,RAJASTHAN,Tonk,1421326,880194,334006,205593,1533,728136,693190,749659,478329,271330,113426,158264,1908,12482,298911,81755,380666,
121,RAJASTHAN,Bundi,1110906,686771,267648,155958,529,577160,533746,585044,371705,213339,111388,136969,1392,7705,239836,63452,303288,
122,RAJASTHAN,Bhilwara,2408523,1439454,589476,365023,14570,1220736,1187787,1256126,777582,478544,163052,373644,6207,24014,530015,145865,675880,
123,RAJASTHAN,Rajsamand,1156597,687165,275099,193668,665,581339,575258,619139,383334,235805,106587,193276,1989,9222,304622,61054,365676,
124,RAJASTHAN,Dungarpur,1388552,868458,317700,191917,10477,696532,692020,681591,415820,265771,184330,141275,1477,11742,322816,31547,354363,
125,RAJASTHAN,Banswara,1797485,1153029,406214,216554,21688,907754,889731,829343,513854,315489,199370,120603,2324,15062,390437,39407,429844,
126,RAJASTHAN,Chittaurgarh,1544338,880043,398303,258997,6995,783171,761167,821825,514851,306974,123469,268172,4941,16560,366780,88873,455653,
127,RAJASTHAN,Kota,1951014,1177474,495896,275396,2248,1021161,929853,1298345,765396,532949,134992,339899,12843,36297,203454,311735,515189,
128,RAJASTHAN,Baran,1222755,762204,286344,173100,1107,633945,588810,693307,432607,260700,185037,161310,1363,9491,249184,69804,318988,
129,RAJASTHAN,Jhalawar,1411129,850546,346110,213674,799,725143,685986,739792,466815,272977,209772,220428,1750,9403,298624,63763,362387,
130,RAJASTHAN,Udaipur,3068420,1876436,739287,451034,1663,1566801,1501619,1582629,973444,609185,302968,357846,14211,48517,665449,182769,848218,
131,RAJASTHAN,Pratapgarh,867848,545987,204801,115608,1452,437744,430104,401515,250122,151393,96815,71612,716,5961,209813,24269,234082,
132,UTTAR PRADESH,Saharanpur,3466382,2228689,769736,433862,34095,1834106,1632276,2077108,1220114,856994,273050,404499,9699,38816,605082,284156,889238,
133,UTTAR PRADESH,Muzaffarnagar,4143512,2671757,911621,544283,15851,2193434,1950078,2417339,1448528,968811,323641,368153,10077,56149,673746,296104,969850,
134,UTTAR PRADESH,Bijnor,3682713,2404576,786305,450186,41646,1921215,1761498,2135393,1241471,893922,311489,268353,7303,37341,683875,224648,908523,
135,UTTAR PRADESH,Moradabad,4772006,3168270,988486,525574,89676,2503186,2268820,2263848,1357435,906413,338384,281758,11690,61846,692398,355518,1047916,
136,UTTAR PRADESH,Rampur,2335819,1576123,491164,258913,9619,1223889,1111930,1043666,630408,413258,230238,131112,3847,25960,396775,143217,539992,
137,UTTAR PRADESH,Jyotiba Phule Nagar,1840221,1227283,391275,215849,5814,963449,876772,983110,600541,382569,131877,89329,2825,18303,335888,115486,451374,
138,UTTAR PRADESH,Meerut,3443689,2165117,780475,451827,46270,1825743,1617946,2141488,1254520,886968,153995,425624,23717,69473,381520,422303,803823,
139,UTTAR PRADESH,Baghpat,1303048,817140,283276,194548,8084,700070,602978,797970,489858,308112,74500,119121,2989,19999,246055,69991,316046,
140,UTTAR PRADESH,Ghaziabad,4681645,2891069,1139871,559963,90742,2488834,2192811,3123264,1811397,1311867,123680,695130,78116,179552,355407,836316,1191723,
141,UTTAR PRADESH,Gautam Buddha Nagar,1648115,1015648,402967,188862,40638,890214,757901,1122947,666065,456882,48845,257586,53181,87188,170835,338935,509770,
142,UTTAR PRADESH,Bulandshahr,3499171,2246254,753949,472808,26160,1845260,1653911,2031656,1253314,778342,241137,223922,7865,38225,658449,221628,880077,
143,UTTAR PRADESH,Aligarh,3673889,2378289,787408,472667,35525,1951996,1721893,2092567,1283380,809187,267197,268120,13634,58336,582117,275942,858059,
144,UTTAR PRADESH,Mahamaya Nagar,1564708,1011157,339137,210083,4331,836127,728581,942572,579157,363415,154720,134579,3087,18621,288150,84883,373033,
145,UTTAR PRADESH,Mathura,2547184,1600686,535738,327854,82906,1367125,1180059,1507746,943346,564400,179248,281239,8726,37596,407488,177802,585290,
146,UTTAR PRADESH,Agra,4418797,2871903,991255,547873,7766,2364953,2053844,2680510,1614594,1065916,234455,536402,27183,82012,496971,406852,903823,
147,UTTAR PRADESH,Firozabad,2498156,1621154,543730,312689,20583,1332046,1166110,1521806,912314,609492,150221,196080,5834,31797,349747,185621,535368,
148,UTTAR PRADESH,Mainpuri,1868529,1193660,402321,265638,6910,993377,875152,1203885,712110,491775,137174,79022,2642,24451,338475,72783,411258,
149,UTTAR PRADESH,Budaun,3681896,2436051,748408,424194,73243,1967759,1714137,1547477,986501,560976,258758,110177,3634,30423,710956,156668,867624,
150,UTTAR PRADESH,Bareilly,4448359,2893965,952233,514141,88020,2357665,2090694,2191759,1342697,849062,326376,272830,15164,56575,631613,362798,994411,
151,UTTAR PRADESH,Pilibhit,2031007,1320476,449673,256276,4582,1072002,959005,1061095,654290,406805,224192,83006,2870,18097,371752,89638,461390,
152,UTTAR PRADESH,Shahjahanpur,3006538,1961237,652237,368743,24321,1606403,1400135,1490930,915142,575788,275192,115163,3889,27533,520289,134714,655003,
153,UTTAR PRADESH,Kheri,4021243,2582597,896611,510832,31203,2123187,1898056,2034044,1237157,796887,422142,122761,3402,29252,754938,107672,862610,
154,UTTAR PRADESH,Sitapur,4483992,2862383,1000987,588318,32304,2375264,2108728,2283733,1397702,886031,473554,102040,3874,34609,827583,111319,938902,
155,UTTAR PRADESH,Hardoi,4092845,2598364,905306,559988,29187,2191442,1901403,2221601,1374587,847014,406830,95508,3845,32065,786613,121064,907677,
156,UTTAR PRADESH,Unnao,3108367,1893706,706851,453462,54348,1630087,1478280,1773584,1053063,720521,332663,99466,3476,28719,596317,121039,717356,
157,UTTAR PRADESH,Lucknow,4589838,2678289,1161686,685258,64605,2394476,2195362,3127260,1742440,1384820,203029,582769,68506,152257,344155,717566,1061721,
158,UTTAR PRADESH,Rae Bareli,3405559,2116007,776583,506583,6386,1752542,1653017,1965843,1165965,799878,507882,247856,5184,34788,705025,73393,778418,
159,UTTAR PRADESH,Farrukhabad,1885204,1224584,411153,246795,2672,1006240,878964,1092677,654827,437850,135679,88081,2624,18733,316647,94843,411490,
160,UTTAR PRADESH,Kannauj,1656616,1069916,361028,223535,2137,881776,774840,1017087,603596,413491,129517,61491,2488,18082,299785,65985,365770,
161,UTTAR PRADESH,Etawah,1581810,979633,362026,237786,2365,845856,735954,1062003,623583,438420,158026,113098,2964,21506,265643,85483,351126,
162,UTTAR PRADESH,Auraiya,1379545,856336,320763,202054,392,740040,639505,930836,546198,384638,151727,65479,2404,14279,255836,58438,314274,
163,UTTAR PRADESH,Kanpur Dehat,1796184,1100820,415918,276272,3174,963255,832929,1170243,692964,477279,234069,49753,2682,25354,363933,41323,405256,
164,UTTAR PRADESH,Kanpur Nagar,4581268,2630411,1209554,731795,9508,2459806,2121462,3243022,1829179,1413843,258790,517271,33966,93296,364869,684906,1049775,
165,UTTAR PRADESH,Jalaun,1689974,1002817,410090,274954,2113,906092,783882,1075196,653430,421766,243035,104176,2217,18615,304856,91565,396421,
166,UTTAR PRADESH,Jhansi,1998603,1171301,510728,308331,8243,1057436,941167,1304513,783705,520808,248072,183340,8517,40774,309592,195321,504913,
167,UTTAR PRADESH,Lalitpur,1221592,793551,265080,159666,3295,641011,580581,641191,397586,243605,131354,77082,1079,9906,258013,43819,301832,
168,UTTAR PRADESH,Hamirpur,1104285,660774,260368,181109,2034,593537,510748,653299,408125,245174,181449,55929,1196,11037,256081,55300,311381,
169,UTTAR PRADESH,Mahoba,875958,527067,201394,137393,10104,466358,409600,488106,302283,185823,130422,42936,1316,11298,198298,48525,246823,
170,UTTAR PRADESH,Banda,1799410,1120432,408527,265310,5141,965876,833534,1002937,630626,372311,273458,73522,1655,18612,378056,67569,445625,
171,UTTAR PRADESH,Chitrakoot,991730,638046,214228,136669,2787,527721,464009,531072,330339,200733,150695,41046,827,9437,207237,23558,230795,
172,UTTAR PRADESH,Fatehpur,2632733,1624830,603831,395547,8525,1384722,1248011,1512166,911003,601163,425366,75263,3385,33501,558807,77733,636540,
173,UTTAR PRADESH,Pratapgarh,3209141,2002569,703727,492097,10748,1606085,1603056,1931559,1121381,810178,386563,140538,5149,34400,711085,41701,752786,
174,UTTAR PRADESH,Kaushambi,1599596,1034099,336401,210556,18540,838485,761111,813424,507279,306145,321410,43753,1503,15029,349856,30764,380620,
175,UTTAR PRADESH,Allahabad,5954391,3764404,1335224,818137,36626,3131807,2822584,3665727,2199340,1466387,541146,391542,24122,85491,983266,265304,1248570,
176,UTTAR PRADESH,Bara Banki,3260699,2043335,709494,445269,62601,1707073,1553626,1692458,1010518,681940,421973,108116,3159,26293,635840,79068,714908,
177,UTTAR PRADESH,Faizabad,2470996,1534832,543148,367332,25684,1259628,1211368,1450901,838339,612562,272734,127754,4746,28625,510378,79288,589666,
178,UTTAR PRADESH,Ambedkar Nagar,2397888,1499494,515229,367234,15931,1212410,1185478,1486939,846676,640263,301120,99581,2509,27308,501559,65031,566590,
179,UTTAR PRADESH,Sultanpur,3797117,2376875,828222,580164,11856,1914586,1882531,2239902,1300248,939654,501634,233701,5956,44008,839737,49891,889628,
180,UTTAR PRADESH,Bahraich,3487731,2275746,754346,446242,11397,1843884,1643847,1398368,878285,520083,482897,85814,2681,35463,698520,61742,760262,
181,UTTAR PRADESH,Shrawasti,1117361,723443,245098,143979,4841,593897,523464,423313,276700,146613,165118,20419,624,10074,248770,8504,257274,
182,UTTAR PRADESH,Balrampur,2148665,1415213,442339,283947,7166,1114721,1033944,868357,544943,323414,328768,57400,1551,15510,410070,35768,445838,
183,UTTAR PRADESH,Gonda,3433919,2223078,734903,464584,11354,1787146,1646773,1679994,1034181,645813,431532,104084,4313,31811,673578,52794,726372,
184,UTTAR PRADESH,Siddharthnagar,2559297,1690396,504002,359977,4922,1295095,1264202,1228926,740718,488208,395993,93088,2434,24662,480165,33348,513513,
185,UTTAR PRADESH,Basti,2464464,1574037,519265,363891,7271,1255272,1209192,1393783,819719,574064,282260,108101,3423,30244,513960,31065,545025,
186,UTTAR PRADESH,Sant Kabir Nagar,1715183,1108368,352395,250502,3918,869656,845527,954949,567098,387851,241825,79525,2031,19729,324972,27179,352151,
187,UTTAR PRADESH,Mahrajganj,2684703,1694493,595114,370573,24523,1381754,1302949,1419144,881674,537470,532486,91844,2694,27339,573046,34033,607079,
188,UTTAR PRADESH,Gorakhpur,4440895,2755630,992114,659677,33474,2277777,2163118,2700328,1593890,1106438,454931,296619,14597,65360,761958,189170,951128,
189,UTTAR PRADESH,Kushinagar,3564544,2236842,772777,500373,54552,1818055,1746489,1954820,1183722,771098,528388,127331,3486,35931,742324,42775,785099,
190,UTTAR PRADESH,Deoria,3100946,1946336,664708,481219,8683,1537436,1563510,1875239,1079288,795951,291016,150001,4469,36068,597778,67928,665706,
191,UTTAR PRADESH,Azamgarh,4613913,2930243,965876,699954,17840,2285004,2328909,2771917,1559414,1212503,452055,183381,6652,47324,891024,80434,971458,
192,UTTAR PRADESH,Mau,2205968,1402738,467343,323260,12627,1114709,1091259,1363044,773082,589962,212343,149908,2656,26716,352207,99321,451528,
193,UTTAR PRADESH,Ballia,3239774,1975934,724362,502628,36850,1672902,1566872,1963590,1160960,802630,384432,119972,4672,42969,564927,64454,629381,
194,UTTAR PRADESH,Jaunpur,4494204,2826453,927026,689979,50746,2220465,2273739,2731677,1565394,1166283,436792,181467,8002,52398,926088,80582,1006670,
195,UTTAR PRADESH,Ghazipur,3620268,2234593,774130,556273,55272,1855075,1765193,2197549,1293553,903996,435934,105767,5309,50180,700173,61467,761640,
196,UTTAR PRADESH,Chandauli,1952756,1222695,437000,287767,5294,1017905,934851,1174606,699454,475152,248674,99602,3492,20762,344937,50822,395759,
197,UTTAR PRADESH,Varanasi,3676841,2260457,856070,531549,28765,1921857,1754984,2403903,1389116,1014787,182146,336056,19214,57583,438935,316129,755064,
198,UTTAR PRADESH,Sant Ravidas Nagar (Bhadohi),1578213,1032294,331743,209920,4256,807099,771114,910146,546782,363364,104419,83220,2896,16198,293510,45997,339507,
199,UTTAR PRADESH,Mirzapur,2496970,1590528,552177,346773,7492,1312302,1184668,1428683,865837,562846,334372,145997,4447,24518,465152,77963,543115,
200,UTTAR PRADESH,Sonbhadra,1862559,1203938,418914,237866,1841,971344,891215,985708,601988,383720,371261,95582,5149,25220,337048,91040,428088,
201,UTTAR PRADESH,Etah,1774480,1149372,383707,237427,3974,947339,827141,1055202,647042,408160,131779,69591,2635,19712,334246,67752,401998,
202,UTTAR PRADESH,Kanshiram Nagar,1436719,946320,301252,183434,5713,764165,672554,724850,452803,272047,107094,50405,1623,13109,271234,72490,343724,
203,BIHAR,Pashchim Champaran,3935042,2544205,888205,497793,4839,2061110,1873932,1759481,1091226,668255,998833,57546,3495,41143,839514,96620,936134,
204,BIHAR,Purba Champaran,5099371,3316422,1122340,648009,12600,2681209,2418162,2276957,1407603,869354,1057417,74979,7719,70258,1142260,101565,1243825,
205,BIHAR,Sheohar,656246,421241,139909,93398,1698,346673,309573,283698,171645,112053,136334,10004,478,6698,158484,7516,166000,
206,BIHAR,Sitamarhi,3423574,2206340,739982,449035,28217,1803252,1620322,1436794,885188,551606,635907,66263,3460,42461,807294,49670,856964,
207,BIHAR,Madhubani,4487379,2860455,1009424,611899,5601,2329313,2158066,2155338,1340085,815253,940642,113281,5319,65548,1047552,41234,1088786,
208,BIHAR,Supaul,2229076,1453438,495020,277610,3008,1155283,1073793,1033283,647672,385611,554271,51028,1845,25078,572287,27815,600102,
209,BIHAR,Araria,2811569,1872943,612012,324091,2523,1463333,1348236,1195768,727643,468125,691947,43290,2561,29796,659061,44213,703274,
210,BIHAR,Kishanganj,1690400,1139615,361114,188447,1224,866970,823430,745056,439921,305135,321867,58718,1093,14073,401793,43357,445150,
211,BIHAR,Purnia,3264619,2155512,696556,372692,39859,1699370,1565249,1332326,805261,527065,745015,86058,4170,33664,712847,85749,798596,
212,BIHAR,Katihar,3071029,2054202,660403,353483,2941,1600430,1470599,1280190,762256,517934,672291,60900,2941,27263,668232,69838,738070,
213,BIHAR,Madhepura,2001762,1311771,444235,242382,3374,1047559,954203,834577,517666,316911,484062,23236,1397,23309,486278,24000,510278,
214,BIHAR,Saharsa,1900661,1249692,415863,233870,1236,997174,903487,804996,506374,298622,356833,41342,1668,19415,432651,38046,470697,
215,BIHAR,Darbhanga,3937385,2535344,865971,529314,6756,2059949,1877436,1816634,1125566,691068,642115,127442,6280,53205,907174,95539,1002713,
216,BIHAR,Muzaffarpur,4801062,3016735,1079189,697108,8030,2527497,2273565,2509232,1487117,1022115,769001,180651,10290,73012,998694,120700,1119394,
217,BIHAR,Gopalganj,2562012,1642807,546202,370662,2341,1267666,1294346,1382998,793905,589093,338666,69375,3707,33596,515925,38133,554058,
218,BIHAR,Siwan,3330464,2115448,713597,498299,3120,1675090,1655374,1930175,1115906,814269,376344,52935,3834,37833,632514,41858,674372,
219,BIHAR,Saran,3951862,2516115,847031,585386,3330,2022821,1929041,2157454,1285767,871687,493461,94787,4509,37442,701323,76299,777622,
220,BIHAR,Vaishali,3495021,2176701,759132,486032,73156,1844535,1650486,1926740,1152576,774164,502637,70001,4810,39564,699317,51494,750811,
221,BIHAR,Samastipur,4261566,2766930,913339,568812,12485,2230003,2031563,2142880,1293575,849305,721629,88021,5379,50918,1012979,43486,1056465,
222,BIHAR,Begusarai,2970541,1951688,644874,369996,3983,1567660,1402881,1548673,918507,630166,430870,120373,4644,43127,594377,139248,733625,
223,BIHAR,Khagaria,1666886,1114645,355531,195796,914,883786,783100,768028,461153,306875,325731,40641,1580,21654,373696,21007,394703,
224,BIHAR,Bhagalpur,3037766,1952879,674660,397654,12573,1615663,1422103,1573066,937669,635397,475228,174534,6764,46929,522527,130634,653161,
225,BIHAR,Banka,2034763,1291235,462080,278863,2585,1067140,967623,965321,590961,374360,462614,62359,1704,22300,425604,18492,444096,
226,BIHAR,Munger,1367765,860147,316713,188319,2586,729041,638724,801817,473741,328076,196449,90461,2653,17946,222281,85782,308063,
227,BIHAR,Lakhisarai,1000912,650642,218840,130655,775,526345,474567,507270,305182,202088,159970,44491,1186,8862,175882,31763,207645,
228,BIHAR,Sheikhpura,636342,413475,136898,85045,924,329743,306599,328676,196431,132245,109696,20065,631,8873,108293,24345,132638,
229,BIHAR,Nalanda,2877653,1829128,642197,403129,3199,1497060,1380593,1519933,919558,600375,534021,101378,4156,43848,514141,102522,616663,
230,BIHAR,Patna,5838465,3626564,1382654,815638,13609,3078512,2759953,3459679,2028047,1431632,658203,546859,40692,132582,657991,552103,1210094,
231,BIHAR,Bhojpur,2728407,1722387,613072,387389,5559,1430380,1298027,1599151,973486,625665,364875,62153,3661,34658,434559,77368,511927,
232,BIHAR,Buxar,1706352,1074754,375372,253998,2228,887977,818375,989807,593544,396263,251790,46760,1784,19324,299252,35405,334657,
233,BIHAR,Kaimur (Bhabua),1626384,1039302,353413,226808,6861,847006,779378,920276,549923,370353,268597,52899,2100,17223,325143,15299,340442,
234,BIHAR,Rohtas,2959918,1875174,673742,407193,3809,1543546,1416372,1799832,1061783,738049,405544,114893,4594,36279,512383,95678,608061,
235,BIHAR,Aurangabad,2540073,1626969,564571,340948,7585,1318684,1221389,1466002,868733,597269,426096,44456,2362,31168,428291,49006,477297,
236,BIHAR,Gaya,4391418,2810026,936630,537333,107429,2266566,2124852,2297613,1368803,928810,783505,112617,6856,57011,696289,111282,807571,
237,BIHAR,Nawada,2219146,1440781,485628,288805,3932,1144668,1074478,1091012,659474,431538,397505,31162,1841,28411,379551,45323,424874,
238,BIHAR,Jamui,1760405,1135919,392052,227016,5418,916064,844341,858588,534385,324203,331466,32633,1839,22414,325909,30851,356760,
239,BIHAR,Jehanabad,1125313,714244,254582,155106,1381,585582,539731,618881,374412,244469,179519,27641,1106,11302,186660,28132,214792,
240,BIHAR,Arwal,700843,444448,156031,98550,1814,363497,337346,386351,235279,151072,144698,2203,413,6378,134334,9960,144294,
241,SIKKIM,North  District,43709,27099,11674,4887,49,24730,18979,30450,18579,11871,2262,7826,116,590,11543,2066,13609,
242,SIKKIM,West District,136435,84209,32520,19400,306,70238,66197,93432,51988,41444,8053,25272,286,1956,32091,1886,33977,
243,SIKKIM,South District,146850,87982,37318,20982,568,76670,70180,106741,59357,47384,4188,27587,591,2626,31135,8163,39298,
244,SIKKIM,East District,283583,165520,80354,37456,253,151432,132151,214329,121345,92984,11483,57893,3291,9662,40626,41512,82138,
245,ARUNACHAL PRADESH,Tawang,49977,30709,13849,5399,20,29151,20826,26073,17720,8353,1581,8635,96,494,10730,2452,13182,
246,ARUNACHAL PRADESH,West Kameng,83947,53026,22362,8493,66,46155,37792,48492,29566,18926,1705,14188,202,887,17889,6306,24195,
247,ARUNACHAL PRADESH,East Kameng,78690,53752,17922,6960,56,38775,39915,38449,21599,16850,1063,5318,57,885,14503,5215,19718,
248,ARUNACHAL PRADESH,Papum Pare,176573,120592,43812,11856,313,89182,87391,121048,65794,55254,1859,30539,2477,7418,20308,30180,50488,
249,ARUNACHAL PRADESH,Upper Subansiri,83448,56054,20055,7230,109,41758,41690,45278,24807,20471,1846,5373,139,750,14542,4672,19214,
250,ARUNACHAL PRADESH,West Siang,112274,70415,28305,13469,85,58168,54106,64746,36777,27969,1384,14204,303,1300,22272,8503,30775,
251,ARUNACHAL PRADESH,East Siang,99214,61993,25334,11802,85,50116,49098,62576,34210,28366,3565,14231,450,1582,19497,9524,29021,
252,ARUNACHAL PRADESH,Upper Siang,35320,21090,8910,5252,68,18699,16621,18195,10723,7472,804,6198,97,392,8569,2182,10751,
253,ARUNACHAL PRADESH,Changlang,148226,96630,35018,16414,164,76948,71278,73174,44027,29147,4208,14593,170,1486,33422,6498,39920,
254,ARUNACHAL PRADESH,Tirap,111975,71785,25669,14423,98,57604,54371,47974,29313,18661,1811,16026,98,888,18420,6500,24920,
255,ARUNACHAL PRADESH,Lower Subansiri,83030,55258,20305,7412,55,41843,41187,54057,29470,24587,1968,12493,381,1598,18112,5365,23477,
256,ARUNACHAL PRADESH,Kurung Kumey,92076,64379,20713,6836,148,45318,46758,36606,20258,16348,2947,3911,95,969,18603,1092,19695,
257,ARUNACHAL PRADESH,Dibang Valley,8004,5113,2088,786,17,4414,3590,4436,2614,1822,106,1074,17,133,2055,1175,3230,
258,ARUNACHAL PRADESH,Lower Dibang Valley,54080,35140,13254,5652,34,28053,26027,31849,18087,13762,3354,5932,207,742,12000,3950,15950,
259,ARUNACHAL PRADESH,Lohit,145726,94890,35493,15195,148,76221,69505,83062,48380,34682,7789,17157,312,1471,33599,11372,44971,
260,ARUNACHAL PRADESH,Anjaw,21167,13913,4755,2456,43,11507,9660,9990,6523,3467,181,1949,27,252,6025,428,6453,
261,NAGALAND,Mon,250260,168773,53600,27437,450,131753,118507,119626,67432,52194,10836,14398,178,2844,43607,7415,51022,
262,NAGALAND,Mokokchung,194622,111243,52853,30363,163,101092,93530,159494,83479,76015,9166,40154,537,2728,37536,17742,55278,
263,NAGALAND,Zunheboto,140757,91709,32267,16730,51,71217,69540,102881,53504,49377,11955,28846,261,2008,31267,6044,37311,
264,NAGALAND,Wokha,166343,106951,40510,18811,71,84505,81838,128208,67385,60823,6438,25268,198,1757,38499,8170,46669,
265,NAGALAND,Dimapur,378811,243392,98601,36618,200,197394,181417,278037,150142,127895,8990,71413,3303,12077,49116,62853,111969,
266,NAGALAND,Phek,163418,108514,37842,16969,93,83743,79675,105893,57926,47967,3159,36182,170,1558,38903,7295,46198,
267,NAGALAND,Tuensang,196596,134573,43210,18762,51,101933,94663,117511,63653,53858,3913,24998,155,2251,40690,9451,50141,
268,NAGALAND,Longleng,50484,33970,11210,5271,33,26502,23982,29859,16139,13720,1309,6416,37,635,12686,2451,15137,
269,NAGALAND,Kiphire,74004,52699,14955,6309,41,37830,36174,41232,22675,18557,1259,14147,47,478,16032,4290,20322,
270,NAGALAND,Kohima,267988,173701,68485,25557,245,138966,129022,197489,107038,90451,2198,50724,1928,7982,31845,44255,76100,
271,NAGALAND,Peren,95219,64393,21597,9156,73,49714,45505,62204,34584,27620,3739,13859,121,1414,20204,4073,24277,
272,MANIPUR,Senapati,479148,314439,111516,52008,1185,247323,231825,264477,148012,116465,30369,22798,256,2170,38008,1826,39834,
273,MANIPUR,Tamenglong,140651,90273,33290,16924,164,72371,68280,85006,47403,37603,1924,11541,125,1362,23982,4119,28101,
274,MANIPUR,Churachandpur,274143,168608,67802,37096,637,138820,135323,195935,104013,91922,8282,29894,837,4496,52972,4853,57825,
275,MANIPUR,Bishnupur,237399,135220,62907,38815,457,118782,118617,156333,87313,69020,15109,34364,676,3447,34977,21172,56149,
276,MANIPUR,Thoubal,422168,251975,107196,62060,937,210845,211323,269304,152617,116687,33106,49507,880,5110,65961,38302,104263,
277,MANIPUR,Imphal West,517992,278940,148146,89394,1512,255054,262938,392626,205985,186641,12870,87078,4913,15066,51055,85746,136801,
278,MANIPUR,Imphal East,456113,261530,123439,70005,1139,226094,230019,324664,173314,151350,20250,78663,2739,9837,64421,46520,110941,
279,MANIPUR,Ukhrul,183998,113715,43646,25165,1472,94718,89280,129829,70148,59681,3852,14026,276,2437,36084,5806,41890,
280,MANIPUR,Chandel,144182,86255,39324,18329,274,74579,69603,90302,51053,39249,8315,18764,184,1782,30377,3783,34160,
281,MIZORAM,Mamit,86364,55914,20082,10318,50,44828,41536,60191,32977,27214,2553,12158,90,1073,16726,4129,20855,
282,MIZORAM,Kolasib,83955,52147,20576,11167,65,42918,41037,65895,34147,31748,5921,14853,367,1986,9669,12507,22176,
283,MIZORAM,Aizawl,400309,235892,108094,56092,231,199270,201039,340595,169547,171048,11434,79804,4019,21093,20570,80341,100911,
284,MIZORAM,Champhai,125745,78778,29690,17189,88,63388,62357,100802,51440,49362,5823,23948,186,2263,18395,12717,31112,
285,MIZORAM,Serchhip,64937,39568,15894,9404,71,32851,32086,54476,27598,26878,1284,12315,131,987,7472,8018,15490,
286,MIZORAM,Lunglei,161428,100250,39690,21424,64,82891,78537,121122,64515,56607,10662,26394,482,3725,21479,17315,38794,
287,MIZORAM,Lawngtlai,117894,80723,25303,11831,37,60599,57295,62861,36444,26417,3153,9283,162,1329,21993,5273,27266,
288,MIZORAM,Saiha,56574,37127,12784,6636,27,28594,27980,42233,21861,20372,957,7400,168,1194,7043,5784,12827,
289,TRIPURA,West Tripura,1725739,940424,499719,284637,959,879428,846311,1361354,722998,638356,156108,314567,6394,36186,289621,217016,506637,
290,TRIPURA,South Tripura,876001,505558,236676,133424,343,447544,428457,646810,351082,295728,111332,133744,948,10393,219171,44906,264077,
291,TRIPURA,Dhalai,378230,232286,95548,50269,127,194544,183686,276217,151643,124574,42201,46875,273,5067,89457,14071,103528,
292,TRIPURA,North Tripura,693947,414878,178608,100274,187,352860,341087,520402,275646,244756,43977,81601,997,10310,150437,42184,192621,
293,MEGHALAYA,West Garo Hills,643291,427629,143604,70599,1459,324159,319132,358702,193438,165264,39725,51301,1630,8872,139351,18594,157945,
294,MEGHALAYA,East Garo Hills,317917,216742,70424,29926,825,161223,156694,192147,102513,89634,19246,24550,288,2368,62698,11518,74216,
295,MEGHALAYA,South Garo Hills,142334,97082,30605,14495,152,73170,69164,82062,45003,37059,5565,10940,179,1625,35930,3713,39643,
296,MEGHALAYA,West Khasi Hills,383461,278569,69988,33431,1473,193715,189746,230678,117307,113371,37184,32873,149,2462,74832,12299,87131,
297,MEGHALAYA,Ribhoi,258840,183343,52945,22365,187,132531,126309,155859,80977,74882,19989,30676,291,1906,57988,5736,63724,
298,MEGHALAYA,East Khasi Hills,825922,545961,192428,86576,957,410749,415173,578030,287270,290760,40889,135941,5032,19306,106248,108843,215091,
299,MEGHALAYA,Jaintia Hills,395124,291097,72934,30362,731,196285,198839,187527,87371,100156,35766,41677,510,4333,76546,7171,83717,
300,ASSAM,Kokrajhar,887142,552671,224715,108956,800,452905,434237,489305,275220,214085,56330,41373,1218,14063,204896,17115,222011,
301,ASSAM,Dhubri,1949258,1286592,439375,221745,1546,997848,951410,922341,511551,410790,171116,72232,1828,26263,460602,60417,521019,
302,ASSAM,Goalpara,1008183,650509,239831,117427,416,513292,494891,563577,304302,259275,75828,78641,1364,13524,228610,39504,268114,
303,ASSAM,Barpeta,1693622,1072312,405046,215355,909,867004,826618,897058,499038,398020,98946,84804,2078,25286,447189,52192,499381,
304,ASSAM,Morigaon,957423,612737,225224,118271,1191,486651,470772,539902,289698,250204,75984,52404,1421,15145,232206,25275,257481,
305,ASSAM,Nagaon,2823768,1778277,678034,366112,1345,1439112,1384656,1710716,921850,788866,196174,195631,5121,45956,674999,124186,799185,
306,ASSAM,Sonitpur,1924110,1159991,501239,261648,1232,983904,940206,1108572,620525,488047,114865,133368,4358,31254,483325,64528,547853,
307,ASSAM,Lakhimpur,1042137,639385,268872,133615,265,529674,512463,683486,375552,307934,43922,60296,1948,15011,293239,34694,327933,
308,ASSAM,Dhemaji,686133,434221,169630,82051,231,351249,334884,423028,237761,185267,19181,28195,1192,10410,211758,16504,228262,
309,ASSAM,Tinsukia,1327929,799874,352158,175377,520,680231,647698,798322,453449,344873,47756,161718,5135,27948,290704,90910,381614,
310,ASSAM,Dibrugarh,1326335,767147,371864,186774,550,676434,649901,884531,491361,393170,61209,136685,8817,34479,299852,77163,377015,
311,ASSAM,Sivasagar,1151050,648056,330947,171710,337,589216,561834,813505,444767,368738,48468,123430,5146,22124,360182,45047,405229,
312,ASSAM,Jorhat,1092256,604908,315550,171062,736,556805,535451,794929,432335,362594,53153,122063,5651,26357,286330,80824,367154,
313,ASSAM,Golaghat,1066888,629153,289085,148244,406,543161,523727,721764,396475,325289,66616,82345,3073,17636,292893,34190,327083,
314,ASSAM,Karbi Anglong,956313,618633,233739,103123,818,490167,466146,557214,314253,242961,60952,53918,1923,11340,215691,37185,252876,
315,ASSAM,Dima Hasao,214102,135463,53699,24830,110,110802,103300,140873,78559,62314,4818,19389,524,3753,37610,21309,58919,
316,ASSAM,Cachar,1736617,1048990,444899,241776,952,886284,850333,1174128,639946,534182,68664,140205,5316,37541,346227,88933,435160,
317,ASSAM,Karimganj,1228686,779850,284368,163990,478,625864,602822,795297,435942,359355,67033,70951,1933,24699,261945,32695,294640,
318,ASSAM,Hailakandi,659296,419921,156243,82841,291,337890,321406,407366,226836,180530,31248,44143,1211,10615,159215,16202,175417,
319,ASSAM,Bongaigaon,738804,458796,184849,94939,220,375818,362986,434078,237114,196964,47406,49866,2523,12959,181923,38470,220393,
320,ASSAM,Chirang,482162,301518,122244,58282,118,244860,237302,259902,145869,114033,35224,22502,747,8627,129018,11613,140631,
321,ASSAM,Kamrup,1517542,895775,408232,212740,795,778461,739081,995319,550219,445100,99522,122191,3109,23468,390596,43849,434445,
322,ASSAM,Kamrup Metropolitan,1253938,659453,401500,190908,2077,647585,606353,1001191,537227,463964,16995,250861,29117,85123,61334,366858,428192,
323,ASSAM,Nalbari,771639,442061,211320,117809,449,396006,375633,531771,293184,238587,34984,68313,1631,12360,210706,28238,238944,
324,ASSAM,Baksa,950075,563089,256282,130083,621,481330,468745,572837,322614,250223,94591,44425,1175,13566,291641,3580,295221,
325,ASSAM,Darrang,928500,583436,226525,118102,437,475273,453227,487039,268666,218373,81617,45444,1166,12084,268517,20189,288706,
326,ASSAM,Udalguri,831668,499214,221518,109962,974,421617,410051,469926,264326,205600,72744,53507,1448,11893,267790,13835,281625,
327,WEST BENGAL,Darjiling,1846823,1031221,523288,289979,2335,937259,909564,1315585,717673,597912,66041,297176,10943,38065,303284,215675,518959,
328,WEST BENGAL,Jalpaiguri,3872846,2259507,1035449,575667,2223,1983064,1889782,2498780,1396622,1102158,349672,382500,9322,48818,798378,319426,1117804,
329,WEST BENGAL,Koch Bihar,2819086,1623320,744646,448761,2359,1451542,1367544,1850504,1028733,821771,391875,186195,3534,34438,803407,97331,900738,
330,WEST BENGAL,Uttar Dinajpur,3007134,1916033,704859,385155,1087,1551066,1456068,1489667,853495,636172,442328,199307,2883,31210,683981,94269,778250,
331,WEST BENGAL,Dakshin Dinajpur,1676276,937283,465982,271423,1588,857199,819077,1083685,596474,487211,279932,168069,2518,24318,390949,70077,461026,
332,WEST BENGAL,Maldah,3988845,2511004,955283,520122,2436,2051541,1937304,2086432,1152019,934413,545759,297716,5357,63525,830318,128678,958996,
333,WEST BENGAL,Murshidabad,7103807,4390564,1717594,991413,4236,3627564,3476243,4055834,2177187,1878647,842294,541169,7951,79729,1501066,350899,1851965,
334,WEST BENGAL,Birbhum,3502404,2008655,952059,539463,2227,1790920,1711484,2158447,1201481,956966,611510,333752,5210,39636,831044,134565,965609,
335,WEST BENGAL,Barddhaman,7717563,4149420,2265543,1292913,9687,3966889,3750674,5247208,2918040,2329168,973182,1049943,32323,141387,1364868,862368,2227236,
336,WEST BENGAL,Nadia,5167600,2745828,1484986,934417,2369,2653768,2513832,3480555,1878866,1601689,556134,623729,12787,77210,1081381,468390,1549771,
337,WEST BENGAL,North Twenty Four Parganas,10009781,5104876,2968996,1921143,14766,5119389,4890392,7608693,4056046,3552647,599039,1608749,105185,307381,1209337,1649803,2859140,
338,WEST BENGAL,Hugli,5519145,2766489,1688206,1060821,3629,2814653,2704492,4078388,2211777,1866611,583380,965258,31725,118459,992085,647953,1640038,
339,WEST BENGAL,Bankura,3596674,1942335,1014764,637834,1741,1838095,1758579,2232992,1299337,933655,647374,334670,4273,34128,900515,90885,991400,
340,WEST BENGAL,Puruliya,2930115,1678057,764776,484166,3116,1496996,1433119,1624905,1002058,622847,492205,189889,3551,32862,653219,99433,752652,
341,WEST BENGAL,Haora,4850029,2587164,1423304,833104,6457,2500819,2349210,3605206,1942824,1662382,181662,796953,30751,99261,483384,869313,1352697,
342,WEST BENGAL,Kolkata,4496694,2025389,1433314,1014769,23222,2356766,2139928,3588137,1926915,1661222,12388,927602,136618,252644,0,1308106,1308106,
343,WEST BENGAL,South Twenty Four Parganas,8161961,4763943,2151474,1235558,10986,4173778,3988183,5531657,3043277,2488380,806562,837874,20665,115871,1568802,611430,2180232,
344,WEST BENGAL,Paschim Medinipur,5913457,3243971,1664250,990179,15057,3007885,2905572,4078412,2266913,1811499,1105201,663811,8970,62108,1364335,201048,1565383,
345,WEST BENGAL,Purba Medinipur,5095875,2866678,1384242,842025,2930,2629834,2466041,3923194,2149073,1774121,702304,530761,9076,67707,1193006,170707,1363713,
346,JHARKHAND,Garhwa,1322784,860869,284036,177599,280,683575,639209,653476,405161,248315,328673,29373,565,8881,272872,19180,292052,
347,JHARKHAND,Chatra,1042886,692650,222892,126682,662,533935,508951,510061,303902,206159,188513,27037,590,9115,200974,14528,215502,
348,JHARKHAND,Kodarma,716259,462098,158603,95309,249,367222,349037,390249,238780,151469,64275,62318,845,7195,116714,34771,151485,
349,JHARKHAND,Giridih,2445474,1597269,533788,312967,1450,1258098,1187376,1253475,783736,469739,362610,125431,1944,19976,452564,46886,499450,
350,JHARKHAND,Deoghar,1492073,944961,338413,205514,3185,775022,717051,793538,489837,303701,209693,130193,1944,13550,257373,64337,321710,
351,JHARKHAND,Godda,1313551,820367,308639,183519,1026,677927,635624,604519,376212,228307,307767,43230,874,11925,276454,15576,292030,
352,JHARKHAND,Sahibganj,1150567,745027,261849,137727,5964,589391,561176,483263,287303,195960,206902,34879,591,9563,223450,37543,260993,
353,JHARKHAND,Pakur,900422,587976,206826,104418,1202,452661,447761,352881,206989,145892,150028,31414,328,4535,200588,16587,217175,
354,JHARKHAND,Dhanbad,2684487,1634835,648876,356445,44331,1405956,1278531,1722204,1014950,707254,103488,427173,11568,46646,258764,405455,664219,
355,JHARKHAND,Bokaro,2062330,1261238,510375,282115,8602,1072807,989523,1273520,759088,514432,126406,274726,9754,37997,250312,258452,508764,
356,JHARKHAND,Lohardaga,461790,298844,100340,62244,362,232629,229161,259707,149568,110139,80840,28769,351,2954,96759,14725,111484,
357,JHARKHAND,Purbi Singhbhum,2293919,1292595,632314,368148,862,1176902,1117017,1507699,856526,651173,209802,382507,22042,63985,262537,342126,604663,
358,JHARKHAND,Palamu,1939869,1244572,425668,268387,1242,1006302,933567,1024563,621706,402857,380976,68238,2155,19981,355529,52375,407904,
359,JHARKHAND,Latehar,726978,484084,152720,89870,304,369666,357312,350682,209706,140976,142729,38194,340,6240,146377,14137,160514,
360,JHARKHAND,Hazaribagh,1734495,1107452,396466,230033,544,890881,843614,1013249,596113,417136,172385,176888,3532,18181,312983,68765,381748,
361,JHARKHAND,Ramgarh,949443,594747,230525,123794,377,494230,455213,596497,350031,246466,46815,149265,2876,12021,134067,118558,252625,
362,JHARKHAND,Dumka,1321442,799323,324226,196164,1729,668514,652928,672409,406275,266134,303084,62110,1193,10396,303697,23281,326978,
363,JHARKHAND,Jamtara,791042,480895,189889,116810,3448,404830,386212,426312,258260,168052,135667,49419,808,4959,165555,20113,185668,
364,JHARKHAND,Ranchi,2914253,1742293,725938,409166,36856,1494937,1419316,1911433,1085244,826189,267360,350908,22538,76565,420740,310242,730982,
365,JHARKHAND,Khunti,531885,327152,125649,78736,348,266335,265550,284575,164741,119834,49448,29157,417,4747,123245,12474,135719,
366,JHARKHAND,Gumla,1025213,643579,225871,155452,311,514390,510823,559720,321795,237925,97918,31687,831,7807,216629,16445,233074,
367,JHARKHAND,Simdega,599578,357859,143560,97817,342,300309,299269,343483,191991,151492,90232,16865,423,4649,144169,11114,155283,
368,JHARKHAND,Pashchimi Singhbhum,1502338,960987,353305,187635,411,749385,752953,727561,439273,288288,267475,121955,1959,12472,336928,63396,400324,
369,JHARKHAND,Saraikela-Kharsawan,1065056,634975,265892,161542,2647,544411,520645,612993,365332,247661,142966,138131,2606,12081,217248,68439,285687,
370,ORISSA,Bargarh,1481255,787033,410005,282422,1795,749161,732094,983783,557217,426566,360650,166909,2401,12343,411566,47395,458961,
371,ORISSA,Jharsuguda,579505,320156,159477,98555,1317,296690,282815,405879,228092,177787,56809,81433,2498,7555,103224,73962,177186,
372,ORISSA,Sambalpur,1041099,565700,286575,186726,2098,526877,514222,703691,393192,310499,160798,126498,5231,14521,220697,94798,315495,
373,ORISSA,Debagarh,312520,176062,81789,53989,680,158230,154290,197819,112649,85170,82490,22453,825,3247,91408,7350,98758,
374,ORISSA,Sundargarh,2093437,1188918,573238,324436,6845,1061147,1032290,1342322,750147,592175,253327,223537,12787,35024,387911,230151,618062,
375,ORISSA,Kendujhar,1801733,1038890,472908,282751,7184,906487,895246,1052518,605119,447399,310075,121830,2622,13167,490634,83664,574298,
376,ORISSA,Mayurbhanj,2519738,1449729,650135,414076,5798,1256213,1263525,1369397,794171,575226,568755,140189,2950,17999,689110,64479,753589,
377,ORISSA,Baleshwar,2320529,1303828,622575,390611,3515,1185787,1134742,1621232,902359,718873,358214,296834,7370,28289,601154,82440,683594,
378,ORISSA,Bhadrak,1506337,848660,393629,260486,3562,760260,746077,1094140,596269,497871,151377,164636,2637,15609,373862,54244,428106,
379,ORISSA,Kendrapara,1440361,771284,374559,290894,3624,717814,722547,1089265,579970,509295,143864,173107,1628,11836,414749,23494,438243,
380,ORISSA,Jagatsinghapur,1136971,577896,317148,238753,3174,577865,559106,889027,481049,407978,110323,139646,3199,13312,309685,43047,352732,
381,ORISSA,Cuttack,2624470,1372301,743090,499895,9184,1352760,1271710,2011469,1103033,908436,248298,349587,15046,40589,579529,210768,790297,
382,ORISSA,Jajapur,1827192,1010147,479392,332706,4947,926034,901158,1290455,706396,584059,186021,192249,3831,17922,495611,45528,541139,
383,ORISSA,Dhenkanal,1192811,641697,326233,222398,2483,612593,580218,829910,464093,365817,163636,117172,1810,10600,315390,36979,352369,
384,ORISSA,Anugul,1273821,708493,347521,213517,4290,655718,618103,869456,494425,375031,172414,131916,5564,15658,340410,74177,414587,
385,ORISSA,Nayagarh,962789,502136,262086,196994,1573,502636,460153,688362,392333,296029,120129,124984,1163,8278,261646,26688,288334,
386,ORISSA,Khordha,2251673,1199521,653346,391701,7105,1167137,1084536,1749936,957515,792421,116274,349860,35701,75588,331834,356895,688729,
387,ORISSA,Puri,1698730,888134,477430,328666,4500,865380,833350,1291939,704857,587082,163942,201605,3416,16006,402014,72210,474224,
388,ORISSA,Ganjam,3529031,1980232,924756,613249,10794,1779218,1749813,2210050,1262652,947398,565448,405298,9049,41059,795476,219918,1015394,
389,ORISSA,Gajapati,577817,345387,144043,85072,3315,282882,294935,262537,153663,108874,153199,63112,635,5523,152095,23050,175145,
390,ORISSA,Kandhamal,733110,436625,177471,117777,1237,359945,373165,399786,233900,165886,162932,28736,768,6609,218446,24489,242935,
391,ORISSA,Baudh,441162,253467,111571,75046,1078,221625,219537,271612,158648,112964,104685,19191,245,3430,131377,6577,137954,
392,ORISSA,Subarnapur,610183,341561,153760,113450,1412,311312,298871,398421,230393,168028,139413,50028,708,4289,176927,16575,193502,
393,ORISSA,Balangir,1648997,904026,430011,310876,4084,830097,818900,927260,545672,381588,326416,123446,3286,17274,476770,62192,538962,
394,ORISSA,Nuapada,610382,344075,152681,112325,1301,301962,308420,299383,180903,118480,149834,43976,757,4221,197258,11869,209127,
395,ORISSA,Kalahandi,1576869,880160,415778,275533,5398,787101,789768,802036,484177,317859,436733,91171,1953,12622,456336,38412,494748,
396,ORISSA,Rayagada,967911,577569,245766,140825,3751,471960,495951,407735,241959,165776,248175,61543,1553,9166,237343,49205,286548,
397,ORISSA,Nabarangapur,1220946,745206,297552,171761,6427,604812,616134,470379,286984,183395,328783,34570,1324,8128,342840,29424,372264,
398,ORISSA,Koraput,1379647,818578,348803,207206,5060,678809,700838,568090,340843,227247,290626,85766,3988,17294,381789,78339,460128,
399,ORISSA,Malkangiri,613192,381913,146355,83284,1640,303624,309568,244706,147001,97705,106353,24604,448,3908,167884,15839,183723,
400,CHHATTISGARH,Koriya,658917,399581,165022,94073,241,334737,324180,397823,229923,167900,94648,80023,1667,7609,121852,59763,181615,
401,CHHATTISGARH,Surguja,2359886,1441436,561915,355077,1458,1193129,1166757,1187941,694686,493255,523356,253131,2737,18983,525596,65167,590763,
402,CHHATTISGARH,Jashpur,851669,488965,214455,148100,149,424747,426922,495415,280656,214759,197558,76783,567,5755,205670,20722,226392,
403,CHHATTISGARH,Raigarh,1493984,841958,398257,253488,281,750278,743706,951639,542756,408883,323788,297308,3342,13857,354278,66638,420916,
404,CHHATTISGARH,Korba,1206640,729708,309479,166959,494,612915,593725,748759,433391,315368,221806,202380,4544,18004,206598,126055,332653,
405,CHHATTISGARH,Janjgir - Champa,1619707,975114,383172,260898,523,815717,803990,1019634,593679,425955,402359,339090,1706,10833,379583,61190,440773,
406,CHHATTISGARH,Bilaspur,2663629,1625484,655032,380114,2999,1351574,1312055,1596560,932474,664086,572292,519704,8566,30892,549632,188174,737806,
407,CHHATTISGARH,Kabeerdham,822526,515971,198517,107854,184,412058,410468,414167,248503,165664,185850,150649,682,2962,187311,23868,211179,
408,CHHATTISGARH,Rajnandgaon,1537133,898915,404418,233068,732,762855,774278,1008379,561355,447024,290108,275501,2111,11790,313604,76528,390132,
409,CHHATTISGARH,Durg,3343872,1919832,898241,523656,2143,1682101,1661771,2303378,1284612,1018766,560415,614109,16141,51289,533448,349741,883189,
410,CHHATTISGARH,Raipur,4063872,2454299,1038155,560184,11234,2048186,2015686,2629749,1493158,1136591,708993,728556,20261,59523,673499,395001,1068500,
411,CHHATTISGARH,Mahasamund,1032754,582544,272009,177826,375,511967,520787,637963,364089,273874,278073,212487,961,5614,274793,35774,310567,
412,CHHATTISGARH,Dhamtari,799781,461125,213021,125429,206,397897,401884,546833,303924,242909,182602,148926,1016,4804,168689,41792,210481,
413,CHHATTISGARH,Uttar Bastar Kanker,748941,437598,197603,113450,290,373338,375603,456042,258298,197744,129142,110208,579,4084,169191,24878,194069,
414,CHHATTISGARH,Bastar,1413199,864272,358157,189569,1201,698487,714712,650863,382335,268528,287828,157646,1782,9042,316425,54894,371319,
415,CHHATTISGARH,Narayanpur,139820,91338,33956,14367,159,70104,69716,56621,33449,23172,13820,9316,86,589,26916,6179,33095,
416,CHHATTISGARH,Dakshin Bastar Dantewada,533638,334987,140188,58170,293,264142,269496,191237,116529,74708,69385,43608,955,3879,106545,31304,137849,
417,CHHATTISGARH,Bijapur,255230,167348,63802,23927,153,128663,126567,86919,54076,32843,49859,12516,117,1462,50449,7942,58391,
418,MADHYA PRADESH,Sheopur,687861,449974,155063,82416,408,361784,326077,328025,208201,119824,115261,74770,273,5393,150146,26376,176522,
419,MADHYA PRADESH,Morena,1965970,1254302,452484,257704,1480,1068417,897553,1179685,747652,432033,148222,131486,1781,20172,319298,95288,414586,
420,MADHYA PRADESH,Bhind,1703005,1040736,399676,258588,4005,926843,776162,1094917,676513,418404,158266,107819,1166,14368,271211,88385,359596,
421,MADHYA PRADESH,Gwalior,2032036,1218319,519728,291451,2538,1090327,941709,1357210,803114,554096,120348,306859,15779,46454,172720,272172,444892,
422,MADHYA PRADESH,Datia,786754,473097,195131,118186,340,420157,366597,491445,303815,187630,93744,97696,616,5251,160453,43401,203854,
423,MADHYA PRADESH,Shivpuri,1726050,1106084,389652,227989,2325,919795,806255,900846,573242,327604,220440,148128,1852,15304,367859,66759,434618,
424,MADHYA PRADESH,Tikamgarh,1445166,898323,343824,201875,1144,760355,684811,747940,459353,288587,223852,132725,1090,10899,322772,60220,382992,
425,MADHYA PRADESH,Chhatarpur,1762375,1112636,394060,252417,3262,936121,826254,943033,572010,371023,238364,176056,1880,15567,375869,95048,470917,
426,MADHYA PRADESH,Panna,1016520,635347,235035,144827,1311,533480,483040,552559,332140,220419,198847,76097,653,8501,256744,32179,288923,
427,MADHYA PRADESH,Sagar,2378458,1470688,569166,335432,3172,1256257,1122201,1545719,908607,637112,378560,366494,4546,24811,448408,165507,613915,
428,MADHYA PRADESH,Damoh,1264219,768929,312593,181403,1294,661873,602346,747715,445737,301978,250165,187731,1432,10504,303387,66514,369901,
429,MADHYA PRADESH,Satna,2228935,1365647,535086,326049,2153,1157495,1071440,1371781,801051,570730,371584,294702,3754,22751,461831,114173,576004,
430,MADHYA PRADESH,Rewa,2365106,1460075,540235,362228,2568,1225100,1140006,1441757,845572,596185,463506,251132,3406,31194,523910,94489,618399,
431,MADHYA PRADESH,Umaria,644758,403030,158140,82984,604,330674,314084,356672,210907,145765,145690,67975,839,6360,138100,29966,168066,
432,MADHYA PRADESH,Neemuch,826067,476995,217403,131227,442,422653,403414,508834,307889,200945,136330,145258,1945,8342,174235,67962,242197,
433,MADHYA PRADESH,Mandsaur,1340411,781000,346861,211815,735,682851,657560,834591,502898,331693,266350,239885,2324,12507,302287,81832,384119,
434,MADHYA PRADESH,Ratlam,1455069,876905,363858,213560,746,738241,716828,825880,485090,340790,305946,213825,3644,14905,266716,107151,373867,
435,MADHYA PRADESH,Ujjain,1986864,1156749,508302,320502,1311,1016289,970575,1240990,730817,510173,302003,323379,7501,27733,300765,188684,489449,
436,MADHYA PRADESH,Shajapur,1512681,901161,369741,240768,1011,780520,732161,894612,543509,351103,303157,232735,1382,10797,312611,73997,386608,
437,MADHYA PRADESH,Dewas,1563715,943954,388648,230280,833,805359,758356,925369,550716,374653,310606,270457,3518,16523,274995,101014,376009,
438,MADHYA PRADESH,Dhar,2185793,1377326,533243,273050,2174,1112725,1073068,1077338,638479,438859,437437,349639,2388,18626,412348,103364,515712,
439,MADHYA PRADESH,Indore,3276697,1877270,894464,493096,11867,1699627,1577070,2309130,1289631,1019499,185528,593576,48691,111478,200371,587947,788318,
440,MADHYA PRADESH,Khargone (West Nimar),1873046,1166866,450248,254570,1362,953121,919925,986234,575428,410806,425712,304291,2162,14189,383543,76620,460163,
441,MADHYA PRADESH,Barwani,1385881,923665,302833,158594,789,699340,686541,549926,313642,236284,267196,181139,1158,8516,250358,48912,299270,
442,MADHYA PRADESH,Rajgarh,1545814,935230,363218,246447,919,790212,755602,804245,488797,315448,330820,231130,1611,12718,331894,69823,401717,
443,MADHYA PRADESH,Vidisha,1458875,919239,335690,203005,941,769568,689307,862918,512344,350574,228308,181510,1926,12888,292579,83830,376409,
444,MADHYA PRADESH,Bhopal,2371061,1405814,625594,330291,9362,1236130,1134931,1660690,920314,740376,105195,452912,40788,94729,118893,581826,700719,
445,MADHYA PRADESH,Sehore,1311332,817608,305605,187611,508,683743,627589,780362,469208,311154,227026,212138,1566,11166,270427,59220,329647,
446,MADHYA PRADESH,Raisen,1331597,832939,316319,181524,815,700358,631239,820220,479093,341127,228151,194373,1141,9931,251272,74441,325713,
447,MADHYA PRADESH,Betul,1575362,938819,392728,242592,1223,799236,776126,939769,529783,409986,358157,230974,2109,13755,318945,87704,406649,
448,MADHYA PRADESH,Harda,570465,347774,138882,83417,392,294838,275627,352550,203807,148743,101256,95066,986,5376,112714,31845,144559,
449,MADHYA PRADESH,Hoshangabad,1241350,730768,318232,191501,849,648725,592625,810644,469199,341445,181967,198076,2871,14456,209650,105746,315396,
450,MADHYA PRADESH,Katni,1292042,778414,326582,185857,1189,662013,630029,790773,460583,330190,223902,172416,2179,13094,276151,72880,349031,
451,MADHYA PRADESH,Jabalpur,2463289,1387369,679185,391903,4832,1277278,1186011,1756468,980307,776161,283636,452023,20443,58601,272284,352477,624761,
452,MADHYA PRADESH,Narsimhapur,1091854,620415,289560,180831,1048,568810,523044,718785,413491,305294,257865,172144,1603,9751,230659,53059,283718,
453,MADHYA PRADESH,Dindori,704524,419531,181841,102522,630,351913,352611,378714,222759,155955,190962,62372,554,6447,218021,9774,227795,
454,MADHYA PRADESH,Mandla,1054905,614794,278553,160510,1048,525272,529633,604962,348033,256929,318909,143803,912,9042,279674,37258,316932,
455,MADHYA PRADESH,Chhindwara,2090922,1232263,535316,321977,1366,1064468,1026454,1294198,731294,562904,422668,344875,3588,20034,413142,140802,553944,
456,MADHYA PRADESH,Seoni,1379131,809922,363037,205237,935,695879,683252,864194,485341,378853,376404,228695,1182,10417,335045,47542,382587,
457,MADHYA PRADESH,Balaghat,1701698,969773,453605,276799,1521,842178,859520,1147623,626468,521155,459796,277927,1712,13306,400074,70793,470867,
458,MADHYA PRADESH,Guna,1241519,793150,285176,162104,1089,649362,592157,653980,400537,253443,175615,144248,2482,11740,212765,72320,285085,
459,MADHYA PRADESH,Ashoknagar,845071,535410,194772,114131,758,443837,401234,469109,290304,178805,122387,84720,619,6016,169606,37135,206741,
460,MADHYA PRADESH,Shahdol,1066063,645619,269145,150655,644,540021,526042,604194,348761,255433,258991,113184,1733,10817,233594,57846,291440,
461,MADHYA PRADESH,Anuppur,749237,444954,193520,109813,950,379114,370123,436595,254120,182475,130376,81338,1290,7266,147388,60325,207713,
462,MADHYA PRADESH,Sidhi,1127033,721531,253685,150959,858,575912,551121,600785,353030,247755,262030,102228,837,10790,250953,25916,276869,
463,MADHYA PRADESH,Singrauli,1178273,771725,267189,138276,1083,613637,564636,585054,359923,225131,228472,73091,2627,13939,228732,58593,287325,
464,MADHYA PRADESH,Jhabua,1025048,684200,220769,119681,398,515023,510025,352081,214582,137499,115649,125411,744,5591,211080,24713,235793,
465,MADHYA PRADESH,Alirajpur,728999,488848,155328,84149,674,362542,366457,209754,120905,88849,73693,81006,297,5126,135866,14662,150528,
466,MADHYA PRADESH,Khandwa (East Nimar),1310061,809091,313456,186928,586,674329,635732,731615,432259,299356,306623,202710,1907,10404,265663,63425,329088,
467,MADHYA PRADESH,Burhanpur,757847,469838,181605,106034,370,388504,369343,408679,233073,175606,156295,112420,986,5058,115979,62861,178840,
468,GUJARAT,Kachchh,2092371,1278604,524052,286086,3629,1096737,995634,1252319,739239,513080,183971,403294,9631,31961,488293,250982,739275,
469,GUJARAT,Banas Kantha,3120506,1984701,738412,394793,2600,1610379,1510127,1704923,1048402,656521,350541,396873,3424,23149,666773,137424,804197,
470,GUJARAT,Patan,1343734,786357,341381,213465,2531,694397,649337,837913,494631,343282,227080,223424,2231,12870,301483,102655,404138,
471,GUJARAT,Mahesana,2035064,1119451,554432,357578,3603,1056520,978544,1502645,847499,655146,242969,385609,7759,33731,476005,183738,659743,
472,GUJARAT,Sabar Kantha,2428589,1393131,630963,400905,3590,1244231,1184358,1578734,918625,660109,333867,438606,5262,25425,544024,121509,665533,
473,GUJARAT,Gandhinagar,1391753,769329,391862,224886,5676,723864,667889,1030494,582686,447808,129356,262539,12107,33662,237624,195634,433258,
474,GUJARAT,Ahmadabad,7214225,3952858,2043895,1198152,19320,3788051,3426174,5435760,3025463,2410297,268954,1456046,126341,273651,353169,1845383,2198552,
475,GUJARAT,Surendranagar,1756268,1033435,439352,280582,2899,909917,846351,1093626,643221,450405,270861,302068,2975,15309,340788,159810,500598,
476,GUJARAT,Rajkot,3804558,2080568,1052871,659576,11543,1974445,1830113,2725056,1514075,1210981,214285,747352,21785,67370,459474,721532,1181006,
477,GUJARAT,Jamnagar,2160119,1220598,576319,358455,4747,1114192,1045927,1396534,795140,601394,147193,386538,11573,30384,347158,299167,646325,
478,GUJARAT,Porbandar,585449,314886,163777,105638,1148,300209,285240,393678,221621,172057,48964,117040,1653,5639,96015,87557,183572,
479,GUJARAT,Junagadh,2743082,1527888,749156,461650,4388,1404356,1338726,1842818,1046981,795837,333996,498326,6628,26991,489237,287506,776743,
480,GUJARAT,Amreli,1514190,836343,389892,282409,5546,771049,743141,995459,558180,437279,209935,273331,2538,12765,313714,116899,430613,
481,GUJARAT,Bhavnagar,2880365,1708938,720241,445121,6065,1490201,1390164,1887255,1087371,799884,334025,500757,7297,28925,387251,356826,744077,
482,GUJARAT,Anand,2092745,1134962,585093,366419,6271,1087224,1005521,1551253,874481,676772,346329,378310,9902,32523,413078,208909,621987,
483,GUJARAT,Kheda,2299885,1260660,628221,388646,22358,1185727,1114158,1660243,942480,717763,359842,372226,5710,24502,461479,160547,622026,
484,GUJARAT,Panch Mahals,2390776,1421859,599925,363391,5601,1226961,1163815,1440805,858054,582751,376038,398937,3456,19753,463363,104238,567601,
485,GUJARAT,Dohad,2127086,1402616,467115,252153,5202,1068651,1058435,1007171,599035,408136,438597,241117,1733,13497,323697,52807,376504,
486,GUJARAT,Vadodara,4165626,2213474,1190041,733710,28401,2153736,2011890,2893080,1614087,1278993,570361,798277,53606,117818,547454,692971,1240425,
487,GUJARAT,Narmada,590297,336830,157910,93466,2091,301086,289211,370336,211767,158569,188030,101940,576,4081,138121,22248,160369,
488,GUJARAT,Bharuch,1551019,844298,442523,254728,9470,805707,745312,1118276,623047,495229,253577,309091,10257,29531,300677,181319,481996,
489,GUJARAT,The Dangs,228291,146095,51821,30027,348,113821,114470,140968,77314,63654,40486,29794,137,1393,52102,7516,59618,
490,GUJARAT,Navsari,1329672,673014,390349,258957,7352,678165,651507,1001909,539471,462438,206608,267679,6726,24397,267739,141417,409156,
491,GUJARAT,Valsad,1705678,944532,485874,259906,15366,887222,818456,1170657,655528,515129,183025,329218,11020,31285,262410,235981,498391,
492,GUJARAT,Surat,6081322,3563443,1740746,723415,53718,3402224,2679098,4571410,2687468,1883942,325739,1252452,55694,149331,369840,1529998,1899838,
493,GUJARAT,Tapi,807022,422047,235019,144575,5381,402188,404834,490036,269007,221029,254786,142370,1601,7567,192272,26217,218489,
494,DAMAN AND DIU,Diu,52074,30475,13932,7599,68,25642,26432,38058,20327,17731,291,10575,368,1055,9788,9062,18850,
495,DAMAN AND DIU,Daman,191173,122589,52868,15428,288,124659,66514,150348,104316,46032,481,49249,1316,4543,10006,61073,71079,
496,DADRA AND NAGAR HAVELI,Dadra AND Nagar Haveli,343709,225103,87888,30346,372,193760,149949,223230,142521,80709,17799,69558,2013,6017,48221,60562,108783,
497,MAHARASHTRA,Nandurbar,1648295,1011352,390419,241534,4990,833170,815125,906509,512099,394410,438176,186202,2579,17047,333440,71572,405012,
498,MAHARASHTRA,Dhule,2050862,1167569,513908,350747,18638,1054031,996831,1293916,723388,570528,429536,315332,6065,27139,382777,146013,528790,
499,MAHARASHTRA,Jalgaon,4229917,2352671,1080237,763529,33480,2197365,2032552,2891882,1629223,1262659,937174,720791,14297,56775,796223,373565,1169788,
500,MAHARASHTRA,Buldana,2586258,1467457,641840,473071,3890,1337560,1248698,1879874,1048892,830982,603227,423036,4767,24877,575405,152787,728192,
501,MAHARASHTRA,Akola,1813906,998769,483200,327932,4005,932334,881572,1411281,758977,652304,388521,314490,6163,24232,308158,196077,504235,
502,MAHARASHTRA,Washim,1197160,682919,302425,210185,1631,620302,576858,869917,487703,382214,310195,196022,1875,10757,274925,55921,330846,
503,MAHARASHTRA,Amravati,2888445,1540590,783549,553265,11041,1480768,1407677,2251875,1207104,1044771,667943,512492,9438,36185,508921,272894,781815,
504,MAHARASHTRA,Wardha,1300774,659540,370227,270107,900,668385,632389,1019458,552617,466841,282170,266155,4313,16260,268486,120218,388704,
505,MAHARASHTRA,Nagpur,4653570,2460820,1361821,818467,12462,2384975,2268595,3673808,1959220,1714588,423587,917626,57964,135750,430844,877522,1308366,
506,MAHARASHTRA,Bhandara,1200334,626978,333120,232754,7482,605520,594814,899860,488709,411151,312183,227025,2932,13165,283843,72575,356418,
507,MAHARASHTRA,Gondiya,1322507,704214,371908,244111,2274,661554,660953,1004243,542837,461406,281414,239981,2866,13595,319702,66813,386515,
508,MAHARASHTRA,Gadchiroli,1072942,605217,289448,175518,2759,541328,531614,708365,395110,313255,247813,145459,1663,11064,293586,37254,330840,
509,MAHARASHTRA,Chandrapur,2204307,1163802,629890,403719,6896,1123834,1080473,1578615,872565,706050,473983,418666,8239,31419,451324,233331,684655,
510,MAHARASHTRA,Yavatmal,2772348,1549263,733258,483813,6014,1419965,1352383,2022574,1115980,906594,739718,446516,6094,29917,629243,168889,798132,
511,MAHARASHTRA,Nanded,3361292,2008314,809135,535827,8016,1730075,1631217,2189425,1255222,934203,632395,488748,7548,43055,591119,230563,821682,
512,MAHARASHTRA,Hingoli,1177345,692117,281905,201828,1495,606294,571051,790743,450551,340192,226483,159114,1221,9676,242456,41913,284369,
513,MAHARASHTRA,Parbhani,1836086,1078349,436486,313455,7796,942870,893216,1157814,666291,491523,317806,272486,3982,21196,293480,133759,427239,
514,MAHARASHTRA,Jalna,1959046,1150104,454836,341479,12627,1011473,947573,1195523,699428,496095,300937,288895,3791,17236,404746,98084,502830,
515,MAHARASHTRA,Aurangabad,3701282,2211996,909771,571932,7583,1924469,1776813,2503837,1430936,1072901,396630,589477,23258,69937,551789,427343,979132,
516,MAHARASHTRA,Nashik,6107187,3580633,1567252,948469,10833,3157186,2950001,4345366,2397538,1947828,730228,904710,45039,138887,904661,764271,1668932,
517,MAHARASHTRA,Thane,11060148,6184519,3241888,1579921,53820,5865078,5195070,8227161,4591396,3635765,418004,2231800,256170,551643,713994,2904157,3618151,
518,MAHARASHTRA,Mumbai Suburban,9356962,4936360,2812001,1575566,33035,5031323,4325639,7575485,4223029,3352456,20722,1964657,404757,652946,0,3078829,3078829,
519,MAHARASHTRA,Mumbai,3085411,1553005,933586,583243,15577,1684608,1400803,2509022,1410680,1098342,5745,625927,121344,204234,0,1107321,1107321,
520,MAHARASHTRA,Raigarh,2634200,1414154,748339,462741,8966,1344345,1289855,1939994,1059692,880302,191182,547206,38570,96301,581868,377160,959028,
521,MAHARASHTRA,Pune,9429408,5184734,2624165,1586132,34377,4924105,4505303,7171723,3940210,3231513,414461,1925019,235018,490260,1165718,2056739,3222457,
522,MAHARASHTRA,Ahmadnagar,4543159,2496560,1166245,865139,15215,2342825,2200334,3151890,1773355,1378535,559009,677592,18370,68902,1041393,282011,1323404,
523,MAHARASHTRA,Bid,2585049,1473882,614615,494436,2116,1349106,1235943,1718507,987185,731322,373566,402052,5614,29198,563114,135457,698571,
524,MAHARASHTRA,Latur,2454196,1406364,584243,453229,10360,1273140,1181056,1650672,932432,718240,416578,381722,6217,29758,428616,157016,585632,
525,MAHARASHTRA,Osmanabad,1657576,917343,393539,343021,3673,861535,796041,1137810,644304,493506,299525,240042,3209,18183,367158,77832,444990,
526,MAHARASHTRA,Solapur,4317756,2402794,1089900,809935,15127,2227852,2089904,2910676,1651266,1259410,558334,595560,15145,59296,779929,376302,1156231,
527,MAHARASHTRA,Satara,3003741,1517324,800492,671702,14223,1510842,1492899,2225694,1201034,1024660,297241,562653,14093,57423,774522,200949,975471,
528,MAHARASHTRA,Ratnagiri,1615069,777431,438905,396967,1766,761121,853948,1199392,619012,580380,153117,367352,7752,31062,538538,100824,639362,
529,MAHARASHTRA,Sindhudurg,849651,382024,242296,222963,2368,417332,432319,666067,348289,317778,81816,194228,3517,15721,295847,44989,340836,
530,MAHARASHTRA,Kolhapur,3876001,1972486,1084858,801590,17067,1980658,1895343,2825845,1559760,1266085,266028,770005,22269,71879,796496,382818,1179314,
531,MAHARASHTRA,Sangli,2822143,1450907,752303,603739,15194,1435728,1386415,2049467,1121550,927917,290693,485126,13212,49056,626872,226801,853673,
532,ANDHRA PRADESH,Adilabad,2741239,1536378,704551,422522,77788,1369597,1371642,1483347,856350,626997,484912,566108,5512,45202,597466,220248,817714,
533,ANDHRA PRADESH,Nizamabad,2551335,1399773,676401,437573,37588,1250641,1300694,1389810,790214,599596,448281,545913,5261,35036,565165,155133,720298,
534,ANDHRA PRADESH,Karimnagar,3776269,1940234,1031735,728494,75806,1880800,1895469,2206829,1257238,949591,756859,926768,8831,46584,877236,288044,1165280,
535,ANDHRA PRADESH,Medak,3033288,1735769,779738,509368,8413,1523030,1510258,1637137,953406,683731,571129,604719,8635,47170,593653,195479,789132,
536,ANDHRA PRADESH,Hyderabad,3943323,2249130,1068243,542669,83281,2018575,1924748,2892155,1542688,1349467,23029,869721,149034,274653,0,1066289,1066289,
537,ANDHRA PRADESH,Rangareddy,5296741,2966988,1455864,738037,135852,2701008,2595733,3538028,1948784,1589244,349032,1211352,142879,291745,432098,1129224,1561322,
538,ANDHRA PRADESH,Mahbubnagar,4053028,2360874,1027525,637430,27199,2050386,2002642,1940646,1158386,782260,931084,757821,6153,60812,848963,161052,1010015,
539,ANDHRA PRADESH,Nalgonda,3488809,1932349,897137,651748,7575,1759772,1729037,2001019,1160757,840262,863131,789225,7715,53777,833504,197433,1030937,
540,ANDHRA PRADESH,Warangal,3512576,1891954,941452,664872,14298,1759281,1753295,2065023,1179790,885233,758092,828077,12952,59006,758738,288249,1046987,
541,ANDHRA PRADESH,Khammam,2797370,1530602,774583,477955,14230,1390988,1406382,1630234,901640,728594,804537,668519,8628,42171,669262,201363,870625,
542,ANDHRA PRADESH,Srikakulam,2703114,1423119,747385,528736,3874,1341738,1361376,1495381,857824,637557,700833,615432,3988,32280,752752,149684,902436,
543,ANDHRA PRADESH,Vizianagaram,2344474,1206366,666394,451469,20245,1161477,1182997,1238388,707503,530885,557254,527736,4453,24128,592458,157056,749514,
544,ANDHRA PRADESH,Visakhapatnam,4290589,2274553,1245627,716066,54343,2138910,2151679,2568249,1422878,1145371,578949,1010250,45492,124729,718847,660493,1379340,
545,ANDHRA PRADESH,East Godavari,5154296,2724328,1478954,948122,2892,2569688,2584608,3288577,1716933,1571644,1122046,1297273,22411,93784,1199479,406362,1605841,
546,ANDHRA PRADESH,West Godavari,3936966,2051513,1127764,755533,2156,1964918,1972048,2652389,1379223,1273166,1061787,1017568,12050,55613,1007255,248373,1255628,
547,ANDHRA PRADESH,Krishna,4517398,2340943,1284630,833959,57866,2267375,2250023,3009718,1598959,1410759,1006976,1163932,30438,101450,909292,567042,1476334,
548,ANDHRA PRADESH,Guntur,4887813,2583462,1371811,928462,4078,2440521,2447292,2960441,1634726,1325715,1227956,1186028,19383,80434,1069877,513113,1582990,
549,ANDHRA PRADESH,Prakasam,3397448,1832695,917391,641707,5655,1714764,1682684,1904435,1107686,796749,889218,763746,6151,43611,873486,214089,1087575,
550,ANDHRA PRADESH,Sri Potti Sriramulu Nellore,2963557,1574713,840448,544022,4374,1492974,1470583,1832189,1011922,820267,625262,696024,10201,39583,689137,264376,953513,
551,ANDHRA PRADESH,Y.S.R.,2882469,1553667,793583,530412,4807,1451777,1430692,1716766,994699,722067,542455,671764,6667,39923,590589,293504,884093,
552,ANDHRA PRADESH,Kurnool,4053463,2368684,1053618,609027,22134,2039227,2014236,2127161,1246369,880792,1037302,816721,10081,56478,783853,306982,1090835,
553,ANDHRA PRADESH,Anantapur,4081148,2189396,1104565,739612,47575,2064495,2016653,2310960,1338474,972486,879537,897970,8606,48299,902997,341431,1244428,
554,ANDHRA PRADESH,Chittoor,4174064,2148179,1159053,807430,59402,2090204,2083860,2667878,1484794,1183084,748093,944555,13763,67087,907970,395900,1303870,
555,KARNATAKA,Belgaum,4779661,2669348,1251116,857143,2054,2423063,2356598,3052032,1725548,1326484,649517,808827,17560,73497,962777,356198,1318975,
556,KARNATAKA,Bagalkot,1889752,1123443,465706,299774,829,950111,939641,1113412,641388,472024,303243,301389,3745,26297,324799,165858,490657,
557,KARNATAKA,Bijapur,2177331,1295274,527085,353549,1423,1111022,1066309,1248268,730566,517702,351600,326594,4987,36571,396449,131041,527490,
558,KARNATAKA,Bidar,1703300,1018195,397120,287271,714,870665,832635,1042673,597198,445475,280091,271439,3971,36072,287134,102269,389403,
559,KARNATAKA,Raichur,1928812,1196670,465173,265810,1159,964511,964301,979769,577213,402556,383526,314547,5200,33903,330446,125402,455848,
560,KARNATAKA,Koppal,1389920,855430,330393,202984,1113,699926,689994,809085,468785,340300,273016,223166,2135,15263,272968,64681,337649,
561,KARNATAKA,Gadag,1064570,601578,279069,183409,514,537147,527423,700177,397178,302999,200310,198064,3373,15625,180066,111906,291972,
562,KARNATAKA,Dharwad,1847023,1017935,505688,322577,823,937206,909817,1301664,711776,589888,207642,347962,15013,49585,199707,283397,483104,
563,KARNATAKA,Uttara Kannada,1437169,742281,412649,281542,697,726256,710913,1081906,582099,499807,116336,290791,6129,21501,334281,140511,474792,
564,KARNATAKA,Haveri,1597668,904453,426094,266586,535,819128,778540,1085443,603793,481650,311263,295937,2456,17819,315076,98488,413564,
565,KARNATAKA,Bellary,2452595,1487013,617276,346905,1401,1236954,1215641,1421621,813440,608181,406092,440374,9626,40190,371604,251876,623480,
566,KARNATAKA,Chitradurga,1659456,891230,460057,306412,1757,840843,818613,1087392,607188,480204,294337,307257,5711,28897,349704,97644,447348,
567,KARNATAKA,Davanagere,1945497,1068518,538551,336173,2255,986400,959097,1308540,720637,587903,295873,372671,7320,39416,354680,176011,530691,
568,KARNATAKA,Shimoga,1752753,913150,513297,325542,764,877415,875338,1263016,674938,588078,246464,363835,8791,35207,352444,201662,554106,
569,KARNATAKA,Udupi,1177361,559565,340903,276234,659,562131,615230,926429,465704,460725,63390,224814,9070,24817,269817,115572,385389,
570,KARNATAKA,Chikmagalur,1137961,564994,341380,230864,723,566622,571339,818345,438257,380088,126600,238505,4510,18727,311660,80766,392426,
571,KARNATAKA,Tumkur,2678980,1351461,760936,564196,2387,1350594,1328386,1813391,1006024,807367,352286,562769,7971,41751,685443,204799,890242,
572,KARNATAKA,Bangalore,9621551,5275666,2909575,1424195,12115,5022661,4598890,7512276,4078041,3434235,97914,2330631,430880,790103,300576,2967384,3267960,
573,KARNATAKA,Mandya,1805769,902307,527236,375100,1126,905085,900684,1149649,638668,510981,216159,391033,3367,20265,458867,103435,562302,
574,KARNATAKA,Hassan,1776421,877340,522039,375918,1124,883667,892754,1225256,668836,556420,165910,400702,4851,23444,496103,132878,628981,
575,KARNATAKA,Dakshina Kannada,2089649,1072417,608450,407902,880,1034714,1054935,1666323,864019,802304,29274,386300,23305,55233,332919,317373,650292,
576,KARNATAKA,Kodagu,554519,276918,163360,113919,322,274608,279911,412877,215302,197575,15153,113931,3308,10758,181182,31792,212974,
577,KARNATAKA,Mysore,3001127,1580116,865220,553705,2086,1511600,1489527,1962180,1063766,898414,311002,640868,28397,80086,540596,380386,920982,
578,KARNATAKA,Chamarajanagar,1020791,519046,294903,206003,839,512231,508560,565279,312957,252322,214303,212156,1334,11863,262680,57200,319880,
579,KARNATAKA,Gulbarga,2566326,1570719,604665,388935,2007,1301755,1264571,1427368,828359,599009,415267,404767,9752,52483,400704,199303,600007,
580,KARNATAKA,Yadgir,1174271,738451,267222,168186,412,590329,583942,510003,306751,203252,234655,156222,1410,13216,207787,55208,262995,
581,KARNATAKA,Kolar,1536401,841499,419380,274240,1282,776396,760005,1016219,564110,452109,201233,309494,5051,27235,326567,151042,477609,
582,KARNATAKA,Chikkaballapura,1255104,666451,350299,236864,1490,636437,618667,783222,442158,341064,206939,257243,2672,17360,315649,94053,409702,
583,KARNATAKA,Bangalore Rural,990923,535765,278153,176083,922,509172,481751,688749,385311,303438,84108,214253,3729,17066,231052,95410,326462,
584,KARNATAKA,Ramanagara,1082636,559082,297330,224785,1439,548008,534628,674758,378461,296297,102460,238926,2844,18003,266950,84834,351784,
585,GOA,North Goa,818008,380926,260533,175035,1514,416677,401331,663060,351738,311322,14120,173951,23440,56266,115859,209230,325089,
586,GOA,South Goa,640537,314480,194872,130605,580,322463,318074,502427,264085,238342,12640,138810,17624,44299,88620,162873,251493,
587,LAKSHADWEEP,Lakshadweep,64473,33877,19244,11237,115,33123,31350,52553,28023,24530,0,10669,327,1501,5289,15953,21242,
588,KERALA,Kasaragod,1307375,688763,369883,246975,1754,628613,678762,1037492,516476,521016,38774,237670,10378,32484,251641,166164,417805,
589,KERALA,Kannur,2523003,1187177,741984,588081,5761,1181446,1341557,2138434,1012956,1125478,82988,511167,32653,83940,306288,566191,872479,
590,KERALA,Wayanad,817420,412806,246590,157326,698,401684,415736,645585,328136,317449,101630,149864,4712,15944,266183,11805,277988,
591,KERALA,Kozhikode,3086293,1487644,909581,686109,2959,1470942,1615351,2615443,1266939,1348504,64198,641660,36791,107602,323793,666543,990336,
592,KERALA,Malappuram,4112920,2406005,1041361,662311,3243,1960328,2152592,3311315,1597404,1713911,117405,730119,27909,119918,634543,522586,1157129,
593,KERALA,Palakkad,2809934,1395222,802611,608966,3135,1359478,1450456,2239492,1122600,1116892,249949,587583,27162,69440,665899,228442,894341,
594,KERALA,Thrissur,3121200,1394214,931841,792182,2963,1480763,1640437,2678548,1282261,1396287,73941,721625,56148,132774,336748,715119,1051867,
595,KERALA,Ernakulam,3282388,1396968,1024720,858010,2690,1619557,1662831,2855676,1425723,1429953,71391,771287,88737,184167,369694,804997,1174691,
596,KERALA,Idukki,1108974,494456,352163,261471,884,552808,556166,923010,471881,451129,145698,244844,8250,24863,391610,20823,412433,
597,KERALA,Kottayam,1974551,811653,596302,565048,1548,968289,1006262,1749798,861592,888206,63052,464039,37849,83999,481967,196194,678161,
598,KERALA,Alappuzha,2127789,891512,648522,585591,2164,1013142,1114647,1852797,890552,962245,71706,507913,28842,71593,331419,392117,723536,
599,KERALA,Pathanamthitta,1197412,479207,346161,370887,1157,561716,635696,1062553,499181,563372,55455,302296,21015,49466,414992,57848,472840,
600,KERALA,Kollam,2635375,1177359,795245,660965,1806,1246968,1388407,2240273,1074345,1165928,92193,630767,31542,83133,523715,401415,925130,
601,KERALA,Thiruvananthapuram,3301427,1488441,989238,820024,3724,1581678,1719749,2785408,1354857,1430551,94470,783872,71621,155321,559293,609824,1169117,
602,TAMIL NADU,Thiruvallur,3728104,1925296,1154775,643614,4419,1876062,1852042,2791721,1495711,1296010,270586,909400,75634,174279,387237,732196,1119433,
603,TAMIL NADU,Chennai,4646732,2271657,1468902,899279,6894,2335844,2310888,3776276,1968079,1808197,13674,1096334,217368,355838,0,1314125,1314125,
604,TAMIL NADU,Kancheepuram,3998252,2076492,1200284,715895,5581,2012958,1985294,3013382,1611461,1401921,272514,961161,100322,200738,438799,774705,1213504,
605,TAMIL NADU,Vellore,3936331,2096113,1116437,720713,3068,1961688,1974643,2773928,1504355,1269573,391955,865913,20623,69912,653499,486801,1140300,
606,TAMIL NADU,Tiruvannamalai,2464875,1301347,683904,477668,1956,1235889,1228986,1626813,909803,717010,525063,549077,6445,27529,563102,147061,710163,
607,TAMIL NADU,Viluppuram,3458873,1881463,949892,624042,3476,1740819,1718054,2195776,1234479,961297,832213,748444,8472,43311,808042,159272,967314,
608,TAMIL NADU,Salem,3482056,1737345,1029479,713294,1938,1781571,1700485,2285562,1285107,1000455,454210,835377,20660,63867,572813,597539,1170352,
609,TAMIL NADU,Namakkal,1726601,817905,510413,397064,1219,869280,857321,1176131,653312,522819,253726,441044,8960,31581,370357,257127,627484,
610,TAMIL NADU,Erode,2251744,1006543,701326,542295,1580,1129868,1121876,1492662,828300,664362,370212,595211,18604,58861,411286,432398,843684,
611,TAMIL NADU,The Nilgiris,735394,352516,231451,150804,623,360143,375251,569647,299447,270200,79100,180261,4561,17935,112126,151979,264105,
612,TAMIL NADU,Dindigul,2159775,1065734,647806,443528,2707,1080938,1078837,1481834,816180,665654,467959,500057,9155,38677,443818,269724,713542,
613,TAMIL NADU,Karur,1064493,501585,320645,241843,420,528184,536309,727044,401726,325318,200837,264949,4915,17995,212241,152420,364661,
614,TAMIL NADU,Tiruchirappalli,2722290,1346661,797258,575960,2411,1352284,1370006,2038981,1087765,951216,378782,651621,30046,79588,452707,423020,875727,
615,TAMIL NADU,Perambalur,565223,291371,158218,115151,483,282157,283066,375823,208011,167812,118278,135751,1507,7745,155413,33179,188592,
616,TAMIL NADU,Ariyalur,754894,380484,216103,157771,536,374703,380191,480604,269582,211022,166837,177502,1749,8371,223955,30322,254277,
617,TAMIL NADU,Cuddalore,2605914,1364411,764669,473617,3217,1311697,1294217,1815281,1000322,814959,539412,598412,15396,50938,497429,260780,758209,
618,TAMIL NADU,Nagapattinam,1616450,828444,463326,323706,974,798127,818323,1213008,640916,572092,345057,381940,5585,19692,399016,118724,517740,
619,TAMIL NADU,Thiruvarur,1264277,627880,377118,257116,2163,626693,637584,946471,503085,443386,295188,303114,4416,15535,321331,86848,408179,
620,TAMIL NADU,Thanjavur,2405890,1193095,712017,499235,1543,1182416,1223474,1790998,944264,846734,415361,555582,13495,42912,479070,274302,753372,
621,TAMIL NADU,Pudukkottai,1618345,835853,470428,311175,889,803188,815157,1110545,608776,501769,305149,354493,4494,18272,399712,104229,503941,
622,TAMIL NADU,Sivaganga,1339101,666218,391356,280462,1065,668672,670429,959744,526304,433440,199563,314270,5773,24456,309224,143193,452417,
623,TAMIL NADU,Madurai,3038252,1528178,913715,593827,2532,1526475,1511777,2273430,1223810,1049620,372828,754141,34097,95311,417718,592723,1010441,
624,TAMIL NADU,Theni,1245899,618923,373564,252267,1145,625683,620216,870080,479403,390677,315161,312310,4667,18830,189328,221295,410623,
625,TAMIL NADU,Virudhunagar,1942288,987538,575006,378174,1570,967709,974579,1398788,760375,638413,208702,505950,10219,37357,363782,370942,734724,
626,TAMIL NADU,Ramanathapuram,1353445,708322,389764,252888,2471,682658,670787,978946,536487,442459,153874,291400,5172,22379,290478,126761,417239,
627,TAMIL NADU,Thoothukkudi,1750176,887717,499377,361374,1708,865021,885155,1349697,703106,646591,200644,437916,11455,35791,336078,300661,636739,
628,TAMIL NADU,Tirunelveli,3077233,1554277,876129,644563,2264,1520912,1556321,2273457,1210710,1062747,379763,779130,19070,63590,547962,516705,1064667,
629,TAMIL NADU,Kanniyakumari,1870374,887052,556548,425849,925,926345,944029,1548738,780541,768197,72867,465692,15673,52943,104253,493788,598041,
630,TAMIL NADU,Dharmapuri,1506843,804186,434328,267536,793,774303,732540,917709,527599,390110,267345,337972,3651,18927,396819,91107,487926,
631,TAMIL NADU,Krishnagiri,1879809,1034474,533183,311238,914,960232,919577,1187958,667062,520896,263328,409237,9619,38239,437988,142552,580540,
632,TAMIL NADU,Coimbatore,3458045,1579517,1117221,757738,3569,1729297,1728748,2635907,1394790,1241117,230026,896325,63273,149920,284795,884957,1169752,
633,TAMIL NADU,Tiruppur,2479052,1177987,794639,504674,1752,1246159,1232893,1760566,959623,800943,246333,655073,17181,55311,356886,538022,894908,
634,PONDICHERRY,Yanam,55626,31973,15235,8402,16,27301,28325,39274,19919,19355,3324,12859,207,597,0,15519,15519,
635,PONDICHERRY,PONDICHERRY,950289,473705,299746,176204,634,468258,482031,726649,380946,345703,51908,226316,15437,34007,87296,203741,291037,
636,PONDICHERRY,Mahe,41816,19760,12543,9428,85,19143,22673,36470,16610,19860,82,7150,574,1484,0,12110,12110,
637,PONDICHERRY,Karaikal,200222,102333,60089,37434,366,97809,102413,154916,79903,75013,13077,47880,1868,4870,35618,33715,69333,
638,ANDAMAN AND NICOBAR ISLANDS,Nicobars,36842,18786,12088,5922,46,20727,16115,25332,15397,9935,242,9301,57,230,15958,0,15958,
639,ANDAMAN AND NICOBAR ISLANDS,North  AND Middle Andaman,105597,57350,30741,17464,42,54861,50736,78683,43186,35497,1915,18641,388,1193,39091,1094,40185,
640,ANDAMAN AND NICOBAR ISLANDS,South Andaman,238142,128402,76332,33128,280,127283,110859,190266,105794,84472,2624,52479,2789,6771,34901,50631,85532,
